filename, language, XML, JSON, CSS, JavaScript, HTML, comment, blank, total
c:\Users\AORUS\Desktop\Work_Echart\EChartSimple\.idea\Li_zhi_charts.iml, XML, 12, 0, 0, 0, 0, 0, 0, 12
c:\Users\AORUS\Desktop\Work_Echart\EChartSimple\.idea\misc.xml, XML, 6, 0, 0, 0, 0, 0, 0, 6
c:\Users\AORUS\Desktop\Work_Echart\EChartSimple\.idea\modules.xml, XML, 8, 0, 0, 0, 0, 0, 0, 8
c:\Users\AORUS\Desktop\Work_Echart\EChartSimple\.idea\workspace.xml, XML, 435, 0, 0, 0, 0, 0, 0, 435
c:\Users\AORUS\Desktop\Work_Echart\EChartSimple\css\Horizontal_histogram.css, CSS, 0, 0, 36, 0, 0, 5, 1, 42
c:\Users\AORUS\Desktop\Work_Echart\EChartSimple\css\Table_css.css, CSS, 0, 0, 56, 0, 0, 2, 0, 58
c:\Users\AORUS\Desktop\Work_Echart\EChartSimple\css\Tool\地区三级联动.css, CSS, 0, 0, 278, 0, 0, 54, 41, 373
c:\Users\AORUS\Desktop\Work_Echart\EChartSimple\css\Tool\地区三级联动展示版.css, CSS, 0, 0, 282, 0, 0, 54, 43, 379
c:\Users\AORUS\Desktop\Work_Echart\EChartSimple\css\Tool\导航小地图.css, CSS, 0, 0, 7, 0, 0, 4, 1, 12
c:\Users\AORUS\Desktop\Work_Echart\EChartSimple\css\Vertical_histogram.css, CSS, 0, 0, 36, 0, 0, 5, 1, 42
c:\Users\AORUS\Desktop\Work_Echart\EChartSimple\css\animate.min.css, CSS, 0, 0, 1, 0, 0, 0, 0, 1
c:\Users\AORUS\Desktop\Work_Echart\EChartSimple\css\base.css, CSS, 0, 0, 78, 0, 0, 18, 22, 118
c:\Users\AORUS\Desktop\Work_Echart\EChartSimple\css\home_page.css, CSS, 0, 0, 12, 0, 0, 0, 1, 13
c:\Users\AORUS\Desktop\Work_Echart\EChartSimple\css\hotMap.css, CSS, 0, 0, 22, 0, 0, 0, 1, 23
c:\Users\AORUS\Desktop\Work_Echart\EChartSimple\css\line_chart.css, CSS, 0, 0, 36, 0, 0, 5, 1, 42
c:\Users\AORUS\Desktop\Work_Echart\EChartSimple\css\main.css, CSS, 0, 0, 9, 0, 0, 0, 2, 11
c:\Users\AORUS\Desktop\Work_Echart\EChartSimple\css\swiper-3.4.2.min.css, CSS, 0, 0, 1, 0, 0, 14, 1, 16
c:\Users\AORUS\Desktop\Work_Echart\EChartSimple\css\test.css, CSS, 0, 0, 19, 0, 0, 0, 2, 21
c:\Users\AORUS\Desktop\Work_Echart\EChartSimple\css\展示版\base.css, CSS, 0, 0, 91, 0, 0, 25, 14, 130
c:\Users\AORUS\Desktop\Work_Echart\EChartSimple\css\展示版\政府视角\base.css, CSS, 0, 0, 70, 0, 0, 19, 32, 121
c:\Users\AORUS\Desktop\Work_Echart\EChartSimple\css\展示版\政府视角\万元产值能耗.css, CSS, 0, 0, 17, 0, 0, 8, 3, 28
c:\Users\AORUS\Desktop\Work_Echart\EChartSimple\css\展示版\政府视角\企业异常用能事件.css, CSS, 0, 0, 72, 0, 0, 40, 30, 142
c:\Users\AORUS\Desktop\Work_Echart\EChartSimple\css\展示版\政府视角\企业概况.css, CSS, 0, 0, 23, 0, 0, 0, 10, 33
c:\Users\AORUS\Desktop\Work_Echart\EChartSimple\css\展示版\政府视角\企业能源消费排行.css, CSS, 0, 0, 15, 0, 0, 5, 2, 22
c:\Users\AORUS\Desktop\Work_Echart\EChartSimple\css\展示版\政府视角\区域概况.css, CSS, 0, 0, 24, 0, 0, 10, 10, 44
c:\Users\AORUS\Desktop\Work_Echart\EChartSimple\css\展示版\政府视角\区域能源消费比例.css, CSS, 0, 0, 15, 0, 0, 5, 2, 22
c:\Users\AORUS\Desktop\Work_Echart\EChartSimple\css\展示版\政府视角\区域能源消费结构.css, CSS, 0, 0, 15, 0, 0, 5, 2, 22
c:\Users\AORUS\Desktop\Work_Echart\EChartSimple\css\展示版\政府视角\单位面积能耗.css, CSS, 0, 0, 17, 0, 0, 8, 3, 28
c:\Users\AORUS\Desktop\Work_Echart\EChartSimple\css\展示版\政府视角\年度供需对比 copy.css, CSS, 0, 0, 81, 0, 0, 26, 3, 110
c:\Users\AORUS\Desktop\Work_Echart\EChartSimple\css\展示版\政府视角\年度供需对比.css, CSS, 0, 0, 16, 0, 0, 5, 3, 24
c:\Users\AORUS\Desktop\Work_Echart\EChartSimple\css\展示版\政府视角\年度综合能耗环比.css, CSS, 0, 0, 15, 0, 0, 4, 10, 29
c:\Users\AORUS\Desktop\Work_Echart\EChartSimple\css\展示版\政府视角\度电经济增加值.css, CSS, 0, 0, 17, 0, 0, 8, 3, 28
c:\Users\AORUS\Desktop\Work_Echart\EChartSimple\css\展示版\政府视角\异常用能原因.css, CSS, 0, 0, 15, 0, 0, 5, 2, 22
c:\Users\AORUS\Desktop\Work_Echart\EChartSimple\css\展示版\政府视角\异常能源监测.css, CSS, 0, 0, 24, 0, 0, 10, 10, 44
c:\Users\AORUS\Desktop\Work_Echart\EChartSimple\css\展示版\政府视角\最新异常事件.css, CSS, 0, 0, 70, 0, 0, 38, 29, 137
c:\Users\AORUS\Desktop\Work_Echart\EChartSimple\css\展示版\政府视角\有功图表x.css, CSS, 0, 0, 57, 0, 0, 19, 2, 78
c:\Users\AORUS\Desktop\Work_Echart\EChartSimple\css\展示版\政府视角\标签云.css, CSS, 0, 0, 100, 0, 0, 7, 22, 129
c:\Users\AORUS\Desktop\Work_Echart\EChartSimple\css\展示版\政府视角\清洁能源占比.css, CSS, 0, 0, 15, 0, 0, 5, 2, 22
c:\Users\AORUS\Desktop\Work_Echart\EChartSimple\css\展示版\政府视角\特征图表一.css, CSS, 0, 0, 57, 0, 0, 19, 2, 78
c:\Users\AORUS\Desktop\Work_Echart\EChartSimple\css\展示版\政府视角\特征图表三.css, CSS, 0, 0, 57, 0, 0, 19, 2, 78
c:\Users\AORUS\Desktop\Work_Echart\EChartSimple\css\展示版\政府视角\特征图表二.css, CSS, 0, 0, 57, 0, 0, 19, 2, 78
c:\Users\AORUS\Desktop\Work_Echart\EChartSimple\css\展示版\政府视角\碳排放.css, CSS, 0, 0, 15, 0, 0, 5, 2, 22
c:\Users\AORUS\Desktop\Work_Echart\EChartSimple\css\展示版\政府视角\综合能耗.css, CSS, 0, 0, 15, 0, 0, 5, 3, 23
c:\Users\AORUS\Desktop\Work_Echart\EChartSimple\css\展示版\政府视角\能效环比.css, CSS, 0, 0, 15, 0, 0, 4, 10, 29
c:\Users\AORUS\Desktop\Work_Echart\EChartSimple\css\展示版\政府视角\能级评价指标.css, CSS, 0, 0, 50, 0, 0, 5, 1, 56
c:\Users\AORUS\Desktop\Work_Echart\EChartSimple\css\展示版\政府视角\自我学习趋势图.css, CSS, 0, 0, 15, 0, 0, 5, 2, 22
c:\Users\AORUS\Desktop\Work_Echart\EChartSimple\css\展示版\政府视角\行业能源消费排行.css, CSS, 0, 0, 17, 0, 0, 8, 3, 28
c:\Users\AORUS\Desktop\Work_Echart\EChartSimple\css\展示版\能源企业视角\base.css, CSS, 0, 0, 91, 0, 0, 26, 14, 131
c:\Users\AORUS\Desktop\Work_Echart\EChartSimple\css\展示版\能源企业视角\事件概况.css, CSS, 0, 0, 44, 0, 0, 2, 6, 52
c:\Users\AORUS\Desktop\Work_Echart\EChartSimple\css\展示版\能源企业视角\削峰填谷事件回顾.css, CSS, 0, 0, 86, 0, 0, 26, 30, 142
c:\Users\AORUS\Desktop\Work_Echart\EChartSimple\css\展示版\能源企业视角\区域概况.css, CSS, 0, 0, 25, 0, 0, 9, 10, 44
c:\Users\AORUS\Desktop\Work_Echart\EChartSimple\css\展示版\能源企业视角\客户区域分析.css, CSS, 0, 0, 15, 0, 0, 7, 10, 32
c:\Users\AORUS\Desktop\Work_Echart\EChartSimple\css\展示版\能源企业视角\客户行业分析.css, CSS, 0, 0, 19, 0, 0, 5, 11, 35
c:\Users\AORUS\Desktop\Work_Echart\EChartSimple\css\展示版\能源企业视角\总响应量排行榜.css, CSS, 0, 0, 85, 0, 0, 14, 17, 116
c:\Users\AORUS\Desktop\Work_Echart\EChartSimple\css\展示版\能源企业视角\标签云.css, CSS, 0, 0, 134, 0, 0, 10, 34, 178
c:\Users\AORUS\Desktop\Work_Echart\EChartSimple\css\展示版\能源企业视角\标签云1.css, CSS, 0, 0, 134, 0, 0, 10, 34, 178
c:\Users\AORUS\Desktop\Work_Echart\EChartSimple\css\展示版\能源企业视角\线路负载率.css, CSS, 0, 0, 47, 0, 0, 1, 1, 49
c:\Users\AORUS\Desktop\Work_Echart\EChartSimple\css\展示版\能源企业视角\线路负载率对比.css, CSS, 0, 0, 46, 0, 0, 16, 22, 84
c:\Users\AORUS\Desktop\Work_Echart\EChartSimple\css\展示版\能源企业视角\虚拟电厂出力曲线.css, CSS, 0, 0, 45, 0, 0, 17, 22, 84
c:\Users\AORUS\Desktop\Work_Echart\EChartSimple\css\展示版\能源企业视角\虚拟电厂完结汇总.css, CSS, 0, 0, 66, 0, 0, 23, 29, 118
c:\Users\AORUS\Desktop\Work_Echart\EChartSimple\css\展示版\能源企业视角\近一年削峰填谷事件数量.css, CSS, 0, 0, 15, 0, 0, 9, 12, 36
c:\Users\AORUS\Desktop\Work_Echart\EChartSimple\css\展示版\能源企业视角\高-低负载线路.css, CSS, 0, 0, 88, 0, 0, 26, 24, 138
c:\Users\AORUS\Desktop\Work_Echart\EChartSimple\css\展示版\能源客户视角\base.css, CSS, 0, 0, 91, 0, 0, 16, 15, 122
c:\Users\AORUS\Desktop\Work_Echart\EChartSimple\css\展示版\能源客户视角\企业能效top20.css, CSS, 0, 0, 19, 0, 0, 3, 9, 31
c:\Users\AORUS\Desktop\Work_Echart\EChartSimple\css\展示版\能源客户视角\企业能耗top20.css, CSS, 0, 0, 15, 0, 0, 4, 10, 29
c:\Users\AORUS\Desktop\Work_Echart\EChartSimple\css\展示版\能源客户视角\出线柜.css, CSS, 0, 0, 85, 0, 0, 37, 16, 138
c:\Users\AORUS\Desktop\Work_Echart\EChartSimple\css\展示版\能源客户视角\功率因数行业排名.css, CSS, 0, 0, 31, 0, 0, 7, 12, 50
c:\Users\AORUS\Desktop\Work_Echart\EChartSimple\css\展示版\能源客户视角\功率因素详情.css, CSS, 0, 0, 79, 0, 0, 12, 15, 106
c:\Users\AORUS\Desktop\Work_Echart\EChartSimple\css\展示版\能源客户视角\区域概况.css, CSS, 0, 0, 25, 0, 0, 9, 10, 44
c:\Users\AORUS\Desktop\Work_Echart\EChartSimple\css\展示版\能源客户视角\去年电量构成-楼宇.css, CSS, 0, 0, 15, 0, 0, 5, 10, 30
c:\Users\AORUS\Desktop\Work_Echart\EChartSimple\css\展示版\能源客户视角\去年电量构成-电量峰谷.css, CSS, 0, 0, 33, 0, 0, 8, 12, 53
c:\Users\AORUS\Desktop\Work_Echart\EChartSimple\css\展示版\能源客户视角\变压器.css, CSS, 0, 0, 91, 0, 0, 16, 17, 124
c:\Users\AORUS\Desktop\Work_Echart\EChartSimple\css\展示版\能源客户视角\各月功率因数及力率奖惩电费.css, CSS, 0, 0, 26, 0, 0, 6, 17, 49
c:\Users\AORUS\Desktop\Work_Echart\EChartSimple\css\展示版\能源客户视角\各楼层功能.css, CSS, 0, 0, 79, 0, 0, 19, 17, 115
c:\Users\AORUS\Desktop\Work_Echart\EChartSimple\css\展示版\能源客户视角\各楼层能效.css, CSS, 0, 0, 31, 0, 0, 7, 20, 58
c:\Users\AORUS\Desktop\Work_Echart\EChartSimple\css\展示版\能源客户视角\各楼层能耗.css, CSS, 0, 0, 31, 0, 0, 7, 20, 58
c:\Users\AORUS\Desktop\Work_Echart\EChartSimple\css\展示版\能源客户视角\园区年度综合能耗环比.css, CSS, 0, 0, 15, 0, 0, 12, 12, 39
c:\Users\AORUS\Desktop\Work_Echart\EChartSimple\css\展示版\能源客户视角\园区楼宇能效_单位建筑面积能耗.css, CSS, 0, 0, 15, 0, 0, 4, 10, 29
c:\Users\AORUS\Desktop\Work_Echart\EChartSimple\css\展示版\能源客户视角\园区楼宇能耗排名.css, CSS, 0, 0, 44, 0, 0, 9, 20, 73
c:\Users\AORUS\Desktop\Work_Echart\EChartSimple\css\展示版\能源客户视角\园区能效top20.css, CSS, 0, 0, 28, 0, 0, 6, 16, 50
c:\Users\AORUS\Desktop\Work_Echart\EChartSimple\css\展示版\能源客户视角\园区能效环比.css, CSS, 0, 0, 24, 0, 0, 6, 17, 47
c:\Users\AORUS\Desktop\Work_Echart\EChartSimple\css\展示版\能源客户视角\园区能级评价指标.css, CSS, 0, 0, 51, 0, 0, 6, 12, 69
c:\Users\AORUS\Desktop\Work_Echart\EChartSimple\css\展示版\能源客户视角\园区能耗top20.css, CSS, 0, 0, 15, 0, 0, 4, 10, 29
c:\Users\AORUS\Desktop\Work_Echart\EChartSimple\css\展示版\能源客户视角\套管温度变化.css, CSS, 0, 0, 31, 0, 0, 7, 20, 58
c:\Users\AORUS\Desktop\Work_Echart\EChartSimple\css\展示版\能源客户视角\峰谷平电量占比与峰谷比.css, CSS, 0, 0, 15, 0, 0, 4, 10, 29
c:\Users\AORUS\Desktop\Work_Echart\EChartSimple\css\展示版\能源客户视角\年供需对比曲线.css, CSS, 0, 0, 47, 0, 0, 10, 21, 78
c:\Users\AORUS\Desktop\Work_Echart\EChartSimple\css\展示版\能源客户视角\年度综合能耗环比.css, CSS, 0, 0, 15, 0, 0, 12, 12, 39
c:\Users\AORUS\Desktop\Work_Echart\EChartSimple\css\展示版\能源客户视角\张江人工智能岛.css, CSS, 0, 0, 65, 0, 0, 11, 14, 90
c:\Users\AORUS\Desktop\Work_Echart\EChartSimple\css\展示版\能源客户视角\最大设备利用率.css, CSS, 0, 0, 15, 0, 0, 4, 10, 29
c:\Users\AORUS\Desktop\Work_Echart\EChartSimple\css\展示版\能源客户视角\最大设备利用率行业排名.css, CSS, 0, 0, 31, 0, 0, 7, 12, 50
c:\Users\AORUS\Desktop\Work_Echart\EChartSimple\css\展示版\能源客户视角\楼宇概况.css, CSS, 0, 0, 73, 0, 0, 11, 15, 99
c:\Users\AORUS\Desktop\Work_Echart\EChartSimple\css\展示版\能源客户视角\温度监测-红外图谱.css, CSS, 0, 0, 31, 0, 0, 7, 20, 58
c:\Users\AORUS\Desktop\Work_Echart\EChartSimple\css\展示版\能源客户视角\用电经济性指标同行对比.css, CSS, 0, 0, 16, 0, 0, 5, 10, 31
c:\Users\AORUS\Desktop\Work_Echart\EChartSimple\css\展示版\能源客户视角\电量峰谷比行业排名.css, CSS, 0, 0, 31, 0, 0, 10, 12, 53
c:\Users\AORUS\Desktop\Work_Echart\EChartSimple\css\展示版\能源客户视角\电量峰谷比详情.css, CSS, 0, 0, 79, 0, 0, 19, 15, 113
c:\Users\AORUS\Desktop\Work_Echart\EChartSimple\css\展示版\能源客户视角\能效环比.css, CSS, 0, 0, 39, 0, 0, 8, 14, 61
c:\Users\AORUS\Desktop\Work_Echart\EChartSimple\css\展示版\能源客户视角\能级评价指标.css, CSS, 0, 0, 52, 0, 0, 5, 13, 70
c:\Users\AORUS\Desktop\Work_Echart\EChartSimple\css\展示版\能源客户视角\计量柜.css, CSS, 0, 0, 85, 0, 0, 37, 16, 138
c:\Users\AORUS\Desktop\Work_Echart\EChartSimple\css\展示版\能源客户视角\设备利用率详情.css, CSS, 0, 0, 79, 0, 0, 19, 15, 113
c:\Users\AORUS\Desktop\Work_Echart\EChartSimple\css\展示版\能源客户视角\设备运行状况分析.css, CSS, 0, 0, 71, 0, 0, 11, 15, 97
c:\Users\AORUS\Desktop\Work_Echart\EChartSimple\css\展示版\能源客户视角\进线柜.css, CSS, 0, 0, 85, 0, 0, 37, 16, 138
c:\Users\AORUS\Desktop\Work_Echart\EChartSimple\css\展示版\能源服务市场\base.css, CSS, 0, 0, 91, 0, 0, 27, 38, 156
c:\Users\AORUS\Desktop\Work_Echart\EChartSimple\css\展示版\能源服务市场\产业联盟星级评定.css, CSS, 0, 0, 22, 0, 0, 4, 11, 37
c:\Users\AORUS\Desktop\Work_Echart\EChartSimple\css\展示版\能源服务市场\亿可能源服务公司.css, CSS, 0, 0, 46, 0, 0, 10, 23, 79
c:\Users\AORUS\Desktop\Work_Echart\EChartSimple\css\展示版\能源服务市场\企业标签云.css, CSS, 0, 0, 127, 0, 0, 11, 33, 171
c:\Users\AORUS\Desktop\Work_Echart\EChartSimple\css\展示版\能源服务市场\企业概况.css, CSS, 0, 0, 23, 0, 0, 0, 10, 33
c:\Users\AORUS\Desktop\Work_Echart\EChartSimple\css\展示版\能源服务市场\企业能耗.css, CSS, 0, 0, 16, 0, 0, 4, 10, 30
c:\Users\AORUS\Desktop\Work_Echart\EChartSimple\css\展示版\能源服务市场\区域概况.css, CSS, 0, 0, 25, 0, 0, 9, 10, 44
c:\Users\AORUS\Desktop\Work_Echart\EChartSimple\css\展示版\能源服务市场\历史评价.css, CSS, 0, 0, 121, 0, 0, 16, 30, 167
c:\Users\AORUS\Desktop\Work_Echart\EChartSimple\css\展示版\能源服务市场\各类商品成交趋势.css, CSS, 0, 0, 22, 0, 0, 4, 11, 37
c:\Users\AORUS\Desktop\Work_Echart\EChartSimple\css\展示版\能源服务市场\合同数量变化趋势.css, CSS, 0, 0, 16, 0, 0, 4, 10, 30
c:\Users\AORUS\Desktop\Work_Echart\EChartSimple\css\展示版\能源服务市场\客户区域分析.css, CSS, 0, 0, 16, 0, 0, 6, 10, 32
c:\Users\AORUS\Desktop\Work_Echart\EChartSimple\css\展示版\能源服务市场\客户行业分析.css, CSS, 0, 0, 16, 0, 0, 5, 10, 31
c:\Users\AORUS\Desktop\Work_Echart\EChartSimple\css\展示版\能源服务市场\明星商品销量.css, CSS, 0, 0, 22, 0, 0, 6, 11, 39
c:\Users\AORUS\Desktop\Work_Echart\EChartSimple\css\展示版\能源服务市场\累计需求流失.css, CSS, 0, 0, 22, 0, 0, 4, 11, 37
c:\Users\AORUS\Desktop\Work_Echart\EChartSimple\css\展示版\能源服务市场\经营服务范围.css, CSS, 0, 0, 76, 0, 0, 7, 20, 103
c:\Users\AORUS\Desktop\Work_Echart\EChartSimple\css\展示版\能源服务市场\能效环比.css, CSS, 0, 0, 16, 0, 0, 4, 10, 30
c:\Users\AORUS\Desktop\Work_Echart\EChartSimple\css\展示版\能源服务市场\能源服务市场概括.css, CSS, 0, 0, 25, 0, 0, 9, 10, 44
c:\Users\AORUS\Desktop\Work_Echart\EChartSimple\css\展示版\能源服务市场\需求-商品成交分类占比.css, CSS, 0, 0, 22, 0, 0, 5, 11, 38
c:\Users\AORUS\Desktop\Work_Echart\EChartSimple\css\展示版\能源服务市场\需求-商品成交转换率.css, CSS, 0, 0, 49, 0, 0, 5, 9, 63
c:\Users\AORUS\Desktop\Work_Echart\EChartSimple\css\控制版\main.css, CSS, 0, 0, 330, 0, 0, 14, 54, 398
c:\Users\AORUS\Desktop\Work_Echart\EChartSimple\css\控制版\style.css, CSS, 0, 0, 26, 0, 0, 0, 1, 27
c:\Users\AORUS\Desktop\Work_Echart\EChartSimple\css\控制版\交易总览.css, CSS, 0, 0, 7, 0, 0, 0, 0, 7
c:\Users\AORUS\Desktop\Work_Echart\EChartSimple\css\控制版\交易详情.css, CSS, 0, 0, 156, 0, 0, 1, 4, 161
c:\Users\AORUS\Desktop\Work_Echart\EChartSimple\css\控制版\区域分析.css, CSS, 0, 0, 7, 0, 0, 0, 0, 7
c:\Users\AORUS\Desktop\Work_Echart\EChartSimple\css\控制版\大屏首页.css, CSS, 0, 0, 7, 0, 0, 0, 0, 7
c:\Users\AORUS\Desktop\Work_Echart\EChartSimple\css\控制版\客户特征分析.css, CSS, 0, 0, 183, 0, 0, 1, 4, 188
c:\Users\AORUS\Desktop\Work_Echart\EChartSimple\css\控制版\异常用能分析.css, CSS, 0, 0, 116, 0, 0, 0, 2, 118
c:\Users\AORUS\Desktop\Work_Echart\EChartSimple\css\控制版\服务概况.css, CSS, 0, 0, 7, 0, 0, 0, 0, 7
c:\Users\AORUS\Desktop\Work_Echart\EChartSimple\css\控制版\服务详情.css, CSS, 0, 0, 46, 0, 0, 1, 2, 49
c:\Users\AORUS\Desktop\Work_Echart\EChartSimple\css\控制版\能源应用.css, CSS, 0, 0, 64, 0, 0, 0, 6, 70
c:\Users\AORUS\Desktop\Work_Echart\EChartSimple\css\控制版\能源监控.css, CSS, 0, 0, 7, 0, 0, 0, 0, 7
c:\Users\AORUS\Desktop\Work_Echart\EChartSimple\css\控制版\能源管理.css, CSS, 0, 0, 204, 0, 0, 4, 8, 216
c:\Users\AORUS\Desktop\Work_Echart\EChartSimple\css\监控版\base.css, CSS, 0, 0, 88, 0, 0, 26, 35, 149
c:\Users\AORUS\Desktop\Work_Echart\EChartSimple\css\监控版\能源交易\交易总览\各类商品成交趋势.css, CSS, 0, 0, 50, 0, 0, 12, 25, 87
c:\Users\AORUS\Desktop\Work_Echart\EChartSimple\css\监控版\能源交易\交易总览\商品成交分类占比.css, CSS, 0, 0, 50, 0, 0, 9, 23, 82
c:\Users\AORUS\Desktop\Work_Echart\EChartSimple\css\监控版\能源交易\交易总览\商品成交转换率.css, CSS, 0, 0, 52, 0, 0, 3, 9, 64
c:\Users\AORUS\Desktop\Work_Echart\EChartSimple\css\监控版\能源交易\交易总览\客户区域分析.css, CSS, 0, 0, 50, 0, 0, 8, 23, 81
c:\Users\AORUS\Desktop\Work_Echart\EChartSimple\css\监控版\能源交易\交易总览\客户行业分布占比.css, CSS, 0, 0, 51, 0, 0, 10, 20, 81
c:\Users\AORUS\Desktop\Work_Echart\EChartSimple\css\监控版\能源交易\交易总览\搁置需求列表.css, CSS, 0, 0, 111, 0, 0, 48, 44, 203
c:\Users\AORUS\Desktop\Work_Echart\EChartSimple\css\监控版\能源交易\交易总览\明星商品销量.css, CSS, 0, 0, 51, 0, 0, 9, 23, 83
c:\Users\AORUS\Desktop\Work_Echart\EChartSimple\css\监控版\能源交易\交易总览\累计需求流失分类占比.css, CSS, 0, 0, 50, 0, 0, 8, 22, 80
c:\Users\AORUS\Desktop\Work_Echart\EChartSimple\css\监控版\能源交易\交易总览\能源交易左侧图元.css, CSS, 0, 0, 67, 0, 0, 13, 25, 105
c:\Users\AORUS\Desktop\Work_Echart\EChartSimple\css\监控版\能源交易\交易总览\能源服务商列表.css, CSS, 0, 0, 84, 0, 0, 8, 17, 109
c:\Users\AORUS\Desktop\Work_Echart\EChartSimple\css\监控版\能源交易\交易总览\评分占比.css, CSS, 0, 0, 51, 0, 0, 9, 23, 83
c:\Users\AORUS\Desktop\Work_Echart\EChartSimple\css\监控版\能源交易\交易总览\需求成交分类占比.css, CSS, 0, 0, 50, 0, 0, 9, 23, 82
c:\Users\AORUS\Desktop\Work_Echart\EChartSimple\css\监控版\能源交易\交易总览\需求成交转换率.css, CSS, 0, 0, 52, 0, 0, 3, 9, 64
c:\Users\AORUS\Desktop\Work_Echart\EChartSimple\css\监控版\能源交易\交易详情\上海日月光半导体公司.css, CSS, 0, 0, 61, 0, 0, 5, 11, 77
c:\Users\AORUS\Desktop\Work_Echart\EChartSimple\css\监控版\能源交易\交易详情\企业简介.css, CSS, 0, 0, 73, 0, 0, 8, 17, 98
c:\Users\AORUS\Desktop\Work_Echart\EChartSimple\css\监控版\能源交易\交易详情\合同评价.css, CSS, 0, 0, 114, 0, 0, 3, 16, 133
c:\Users\AORUS\Desktop\Work_Echart\EChartSimple\css\监控版\能源交易\交易详情\商品交易概况.css, CSS, 0, 0, 25, 0, 0, 8, 11, 44
c:\Users\AORUS\Desktop\Work_Echart\EChartSimple\css\监控版\能源交易\交易详情\商品信息.css, CSS, 0, 0, 77, 0, 0, 6, 11, 94
c:\Users\AORUS\Desktop\Work_Echart\EChartSimple\css\监控版\能源交易\交易详情\商品订单数量曲线.css, CSS, 0, 0, 16, 0, 0, 8, 12, 36
c:\Users\AORUS\Desktop\Work_Echart\EChartSimple\css\监控版\能源交易\交易详情\商品详情列表.css, CSS, 0, 0, 324, 0, 0, 48, 75, 447
c:\Users\AORUS\Desktop\Work_Echart\EChartSimple\css\监控版\能源交易\交易详情\设备购买合同.css, CSS, 0, 0, 64, 0, 0, 1, 13, 78
c:\Users\AORUS\Desktop\Work_Echart\EChartSimple\css\监控版\能源交易\交易详情\需求方-上海通用重工.css, CSS, 0, 0, 128, 0, 0, 3, 17, 148
c:\Users\AORUS\Desktop\Work_Echart\EChartSimple\css\监控版\能源交易\交易详情\需求方.css, CSS, 0, 0, 114, 0, 0, 3, 16, 133
c:\Users\AORUS\Desktop\Work_Echart\EChartSimple\css\监控版\能源交易\交易详情\需求详情列表.css, CSS, 0, 0, 322, 0, 0, 48, 74, 444
c:\Users\AORUS\Desktop\Work_Echart\EChartSimple\css\监控版\能源分析\base.css, CSS, 0, 0, 86, 0, 0, 37, 39, 162
c:\Users\AORUS\Desktop\Work_Echart\EChartSimple\css\监控版\能源分析\企业分析\企业能耗综合分析.css, CSS, 0, 0, 20, 0, 0, 5, 11, 36
c:\Users\AORUS\Desktop\Work_Echart\EChartSimple\css\监控版\能源分析\企业分析\功率因数趋势.css, CSS, 0, 0, 26, 0, 0, 6, 13, 45
c:\Users\AORUS\Desktop\Work_Echart\EChartSimple\css\监控版\能源分析\企业分析\区域用能对比.css, CSS, 0, 0, 21, 0, 0, 4, 10, 35
c:\Users\AORUS\Desktop\Work_Echart\EChartSimple\css\监控版\能源分析\企业分析\单位面积能耗趋势.css, CSS, 0, 0, 26, 0, 0, 6, 13, 45
c:\Users\AORUS\Desktop\Work_Echart\EChartSimple\css\监控版\能源分析\企业分析\度电经济产值趋势.css, CSS, 0, 0, 26, 0, 0, 6, 13, 45
c:\Users\AORUS\Desktop\Work_Echart\EChartSimple\css\监控版\能源分析\企业分析\月度区域用能分析.css, CSS, 0, 0, 21, 0, 0, 5, 13, 39
c:\Users\AORUS\Desktop\Work_Echart\EChartSimple\css\监控版\能源分析\企业分析\月度设备用能分析.css, CSS, 0, 0, 21, 0, 0, 5, 13, 39
c:\Users\AORUS\Desktop\Work_Echart\EChartSimple\css\监控版\能源分析\企业分析\碳排放趋势.css, CSS, 0, 0, 26, 0, 0, 6, 13, 45
c:\Users\AORUS\Desktop\Work_Echart\EChartSimple\css\监控版\能源分析\企业分析\综合能耗同比环比对比.css, CSS, 0, 0, 21, 0, 0, 5, 13, 39
c:\Users\AORUS\Desktop\Work_Echart\EChartSimple\css\监控版\能源分析\企业分析\设备用能对比.css, CSS, 0, 0, 21, 0, 0, 3, 8, 32
c:\Users\AORUS\Desktop\Work_Echart\EChartSimple\css\监控版\能源分析\区域分析\产业能源消费占比.css, CSS, 0, 0, 49, 0, 0, 11, 22, 82
c:\Users\AORUS\Desktop\Work_Echart\EChartSimple\css\监控版\能源分析\区域分析\区域概况.css, CSS, 0, 0, 63, 0, 0, 1, 10, 74
c:\Users\AORUS\Desktop\Work_Echart\EChartSimple\css\监控版\能源分析\区域分析\各区域碳排放.css, CSS, 0, 0, 15, 0, 0, 7, 10, 32
c:\Users\AORUS\Desktop\Work_Echart\EChartSimple\css\监控版\能源分析\区域分析\各区域综合能耗.css, CSS, 0, 0, 15, 0, 0, 7, 10, 32
c:\Users\AORUS\Desktop\Work_Echart\EChartSimple\css\监控版\能源分析\区域分析\各区能效.css, CSS, 0, 0, 23, 0, 0, 7, 16, 46
c:\Users\AORUS\Desktop\Work_Echart\EChartSimple\css\监控版\能源分析\区域分析\各行业万元产值能耗.css, CSS, 0, 0, 48, 0, 0, 10, 22, 80
c:\Users\AORUS\Desktop\Work_Echart\EChartSimple\css\监控版\能源分析\区域分析\各行业综合能耗.css, CSS, 0, 0, 48, 0, 0, 10, 22, 80
c:\Users\AORUS\Desktop\Work_Echart\EChartSimple\css\监控版\能源分析\区域分析\行业能源消费占比.css, CSS, 0, 0, 49, 0, 0, 11, 22, 82
c:\Users\AORUS\Desktop\Work_Echart\EChartSimple\css\监控版\能源分析\区域分析\行业能源消费占比_Old.css, CSS, 0, 0, 48, 0, 0, 12, 22, 82
c:\Users\AORUS\Desktop\Work_Echart\EChartSimple\css\监控版\能源分析\区域分析\近30天耗能趋势.css, CSS, 0, 0, 52, 0, 0, 9, 19, 80
c:\Users\AORUS\Desktop\Work_Echart\EChartSimple\css\监控版\能源分析\区域分析\重点企业监控能耗.css, CSS, 0, 0, 15, 0, 0, 9, 12, 36
c:\Users\AORUS\Desktop\Work_Echart\EChartSimple\css\监控版\能源分析\客户特征分析\企业标签演变趋势.css, CSS, 0, 0, 15, 0, 0, 4, 10, 29
c:\Users\AORUS\Desktop\Work_Echart\EChartSimple\css\监控版\能源分析\客户特征分析\企业概况.css, CSS, 0, 0, 73, 0, 0, 10, 13, 96
c:\Users\AORUS\Desktop\Work_Echart\EChartSimple\css\监控版\能源分析\客户特征分析\客户特征分析地图.css, CSS, 0, 0, 167, 0, 0, 27, 12, 206
c:\Users\AORUS\Desktop\Work_Echart\EChartSimple\css\监控版\能源分析\客户特征分析\标签企业列表.css, CSS, 0, 0, 109, 0, 0, 11, 16, 136
c:\Users\AORUS\Desktop\Work_Echart\EChartSimple\css\监控版\能源分析\客户特征分析\标签分类占比.css, CSS, 0, 0, 16, 0, 0, 3, 3, 22
c:\Users\AORUS\Desktop\Work_Echart\EChartSimple\css\监控版\能源分析\客户特征分析\标签概况.css, CSS, 0, 0, 55, 0, 0, 5, 23, 83
c:\Users\AORUS\Desktop\Work_Echart\EChartSimple\css\监控版\能源分析\客户特征分析\标签调用排行.css, CSS, 0, 0, 72, 0, 0, 7, 11, 90
c:\Users\AORUS\Desktop\Work_Echart\EChartSimple\css\监控版\能源分析\异常用能分析\人工复检结果.css, CSS, 0, 0, 56, 0, 0, 5, 4, 65
c:\Users\AORUS\Desktop\Work_Echart\EChartSimple\css\监控版\能源分析\异常用能分析\企业异常事件.css, CSS, 0, 0, 75, 0, 0, 37, 32, 144
c:\Users\AORUS\Desktop\Work_Echart\EChartSimple\css\监控版\能源分析\异常用能分析\企业标签.css, CSS, 0, 0, 34, 0, 0, 3, 6, 43
c:\Users\AORUS\Desktop\Work_Echart\EChartSimple\css\监控版\能源分析\异常用能分析\区域异常排名.css, CSS, 0, 0, 16, 0, 0, 6, 10, 32
c:\Users\AORUS\Desktop\Work_Echart\EChartSimple\css\监控版\能源分析\异常用能分析\年度异常原因变化分析.css, CSS, 0, 0, 16, 0, 0, 8, 12, 36
c:\Users\AORUS\Desktop\Work_Echart\EChartSimple\css\监控版\能源分析\异常用能分析\异常事件列表.css, CSS, 0, 0, 74, 0, 0, 40, 26, 140
c:\Users\AORUS\Desktop\Work_Echart\EChartSimple\css\监控版\能源分析\异常用能分析\异常事件详情.css, CSS, 0, 0, 23, 0, 0, 11, 10, 44
c:\Users\AORUS\Desktop\Work_Echart\EChartSimple\css\监控版\能源分析\异常用能分析\异常原因AI判断.css, CSS, 0, 0, 16, 0, 0, 5, 10, 31
c:\Users\AORUS\Desktop\Work_Echart\EChartSimple\css\监控版\能源分析\异常用能分析\本月异常.css, CSS, 0, 0, 26, 0, 0, 10, 13, 49
c:\Users\AORUS\Desktop\Work_Echart\EChartSimple\css\监控版\能源分析\异常用能分析\行业异常排名.css, CSS, 0, 0, 16, 0, 0, 4, 10, 30
c:\Users\AORUS\Desktop\Work_Echart\EChartSimple\css\监控版\能源分析\异常用能分析\预判准确率趋势.css, CSS, 0, 0, 16, 0, 0, 8, 12, 36
c:\Users\AORUS\Desktop\Work_Echart\EChartSimple\css\监控版\能源应用\专家入驻趋势.css, CSS, 0, 0, 15, 0, 0, 4, 10, 29
c:\Users\AORUS\Desktop\Work_Echart\EChartSimple\css\监控版\能源应用\专家排行.css, CSS, 0, 0, 104, 0, 0, 9, 27, 140
c:\Users\AORUS\Desktop\Work_Echart\EChartSimple\css\监控版\能源应用\优秀成果及孵化项目.css, CSS, 0, 0, 15, 0, 0, 4, 10, 29
c:\Users\AORUS\Desktop\Work_Echart\EChartSimple\css\监控版\能源应用\各类金融类排行.css, CSS, 0, 0, 104, 0, 0, 9, 27, 140
c:\Users\AORUS\Desktop\Work_Echart\EChartSimple\css\监控版\能源应用\合同数量增长趋势.css, CSS, 0, 0, 15, 0, 0, 5, 2, 22
c:\Users\AORUS\Desktop\Work_Echart\EChartSimple\css\监控版\能源应用\成功案例建设趋势.css, CSS, 0, 0, 15, 0, 0, 4, 10, 29
c:\Users\AORUS\Desktop\Work_Echart\EChartSimple\css\监控版\能源应用\成功案例排行.css, CSS, 0, 0, 104, 0, 0, 9, 27, 140
c:\Users\AORUS\Desktop\Work_Echart\EChartSimple\css\监控版\能源应用\最新事件列表.css, CSS, 0, 0, 73, 0, 0, 45, 30, 148
c:\Users\AORUS\Desktop\Work_Echart\EChartSimple\css\监控版\能源应用\能源俱乐部事件排行.css, CSS, 0, 0, 104, 0, 0, 9, 27, 140
c:\Users\AORUS\Desktop\Work_Echart\EChartSimple\css\监控版\能源应用\能源俱乐部类型分类.css, CSS, 0, 0, 15, 0, 0, 3, 9, 27
c:\Users\AORUS\Desktop\Work_Echart\EChartSimple\css\监控版\能源应用\金融产品接入趋势.css, CSS, 0, 0, 15, 0, 0, 4, 10, 29
c:\Users\AORUS\Desktop\Work_Echart\EChartSimple\css\监控版\能源应用\金融渠道类型分布.css, CSS, 0, 0, 25, 0, 0, 8, 11, 44
c:\Users\AORUS\Desktop\Work_Echart\EChartSimple\css\监控版\能源应用\领域入驻专家.css, CSS, 0, 0, 15, 0, 0, 4, 10, 29
c:\Users\AORUS\Desktop\Work_Echart\EChartSimple\css\监控版\能源服务\base.css, CSS, 0, 0, 86, 0, 0, 37, 39, 162
c:\Users\AORUS\Desktop\Work_Echart\EChartSimple\css\监控版\能源服务\定制服务-区域对比.css, CSS, 0, 0, 16, 0, 0, 6, 13, 35
c:\Users\AORUS\Desktop\Work_Echart\EChartSimple\css\监控版\能源服务\定制服务-行业对比.css, CSS, 0, 0, 15, 0, 0, 4, 14, 33
c:\Users\AORUS\Desktop\Work_Echart\EChartSimple\css\监控版\能源服务\定制服务-订单状态.css, CSS, 0, 0, 80, 0, 0, 2, 13, 95
c:\Users\AORUS\Desktop\Work_Echart\EChartSimple\css\监控版\能源服务\定制服务.css, CSS, 0, 0, 73, 0, 0, 51, 42, 166
c:\Users\AORUS\Desktop\Work_Echart\EChartSimple\css\监控版\能源服务\定制服务列表.css, CSS, 0, 0, 74, 0, 0, 39, 31, 144
c:\Users\AORUS\Desktop\Work_Echart\EChartSimple\css\监控版\能源服务\定制服务消费月排行.css, CSS, 0, 0, 82, 0, 0, 40, 39, 161
c:\Users\AORUS\Desktop\Work_Echart\EChartSimple\css\监控版\能源服务\定制服务用户历史订单.css, CSS, 0, 0, 74, 0, 0, 43, 32, 149
c:\Users\AORUS\Desktop\Work_Echart\EChartSimple\css\监控版\能源服务\定制服务类型分布.css, CSS, 0, 0, 16, 0, 0, 5, 12, 33
c:\Users\AORUS\Desktop\Work_Echart\EChartSimple\css\监控版\能源服务\定制服务订单成果.css, CSS, 0, 0, 74, 0, 0, 43, 32, 149
c:\Users\AORUS\Desktop\Work_Echart\EChartSimple\css\监控版\能源服务\定制服务详情.css, CSS, 0, 0, 27, 0, 0, 5, 7, 39
c:\Users\AORUS\Desktop\Work_Echart\EChartSimple\css\监控版\能源服务\定制服务趋势.css, CSS, 0, 0, 15, 0, 0, 5, 13, 33
c:\Users\AORUS\Desktop\Work_Echart\EChartSimple\css\监控版\能源服务\报告订单服务-区域对比.css, CSS, 0, 0, 16, 0, 0, 6, 16, 38
c:\Users\AORUS\Desktop\Work_Echart\EChartSimple\css\监控版\能源服务\报告订单服务-行业对比.css, CSS, 0, 0, 15, 0, 0, 4, 14, 33
c:\Users\AORUS\Desktop\Work_Echart\EChartSimple\css\监控版\能源服务\报告订单服务-订单状态.css, CSS, 0, 0, 80, 0, 0, 1, 11, 92
c:\Users\AORUS\Desktop\Work_Echart\EChartSimple\css\监控版\能源服务\报告订单服务.css, CSS, 0, 0, 71, 0, 0, 51, 43, 165
c:\Users\AORUS\Desktop\Work_Echart\EChartSimple\css\监控版\能源服务\报告订单服务列表.css, CSS, 0, 0, 74, 0, 0, 39, 31, 144
c:\Users\AORUS\Desktop\Work_Echart\EChartSimple\css\监控版\能源服务\报告订单服务消费月排行.css, CSS, 0, 0, 82, 0, 0, 40, 38, 160
c:\Users\AORUS\Desktop\Work_Echart\EChartSimple\css\监控版\能源服务\报告订单服务用户历史订单.css, CSS, 0, 0, 74, 0, 0, 43, 32, 149
c:\Users\AORUS\Desktop\Work_Echart\EChartSimple\css\监控版\能源服务\报告订单服务类型分布.css, CSS, 0, 0, 16, 0, 0, 5, 12, 33
c:\Users\AORUS\Desktop\Work_Echart\EChartSimple\css\监控版\能源服务\报告订单服务订单成果.css, CSS, 0, 0, 74, 0, 0, 43, 32, 149
c:\Users\AORUS\Desktop\Work_Echart\EChartSimple\css\监控版\能源服务\报告订单服务详情.css, CSS, 0, 0, 27, 0, 0, 5, 7, 39
c:\Users\AORUS\Desktop\Work_Echart\EChartSimple\css\监控版\能源服务\接入服务-区域对比.css, CSS, 0, 0, 16, 0, 0, 6, 13, 35
c:\Users\AORUS\Desktop\Work_Echart\EChartSimple\css\监控版\能源服务\接入服务-行业对比.css, CSS, 0, 0, 15, 0, 0, 4, 14, 33
c:\Users\AORUS\Desktop\Work_Echart\EChartSimple\css\监控版\能源服务\接入服务-订单状态.css, CSS, 0, 0, 84, 0, 0, 2, 14, 100
c:\Users\AORUS\Desktop\Work_Echart\EChartSimple\css\监控版\能源服务\接入服务类型分布.css, CSS, 0, 0, 16, 0, 0, 5, 14, 35
c:\Users\AORUS\Desktop\Work_Echart\EChartSimple\css\监控版\能源服务\接入服务详情.css, CSS, 0, 0, 27, 0, 0, 5, 7, 39
c:\Users\AORUS\Desktop\Work_Echart\EChartSimple\css\监控版\能源服务\接入服务趋势.css, CSS, 0, 0, 15, 0, 0, 5, 13, 33
c:\Users\AORUS\Desktop\Work_Echart\EChartSimple\css\监控版\能源服务\接入详情.css, CSS, 0, 0, 73, 0, 0, 44, 32, 149
c:\Users\AORUS\Desktop\Work_Echart\EChartSimple\css\监控版\能源服务\数据接入服务.css, CSS, 0, 0, 71, 0, 0, 49, 40, 160
c:\Users\AORUS\Desktop\Work_Echart\EChartSimple\css\监控版\能源服务\数据接入服务列表.css, CSS, 0, 0, 75, 0, 0, 38, 33, 146
c:\Users\AORUS\Desktop\Work_Echart\EChartSimple\css\监控版\能源服务\最新接入企业.css, CSS, 0, 0, 82, 0, 0, 40, 39, 161
c:\Users\AORUS\Desktop\Work_Echart\EChartSimple\css\监控版\能源服务\服务数量年度对比.css, CSS, 0, 0, 98, 0, 0, 13, 36, 147
c:\Users\AORUS\Desktop\Work_Echart\EChartSimple\css\监控版\能源服务\服务金额年度对比.css, CSS, 0, 0, 98, 0, 0, 12, 38, 148
c:\Users\AORUS\Desktop\Work_Echart\EChartSimple\css\监控版\能源服务\本月报告订单服务趋势.css, CSS, 0, 0, 15, 0, 0, 5, 14, 34
c:\Users\AORUS\Desktop\Work_Echart\EChartSimple\css\监控版\能源监控\base.css, CSS, 0, 0, 88, 0, 0, 35, 39, 162
c:\Users\AORUS\Desktop\Work_Echart\EChartSimple\css\监控版\能源监控\企业监控\企业用能结构.css, CSS, 0, 0, 49, 0, 0, 11, 22, 82
c:\Users\AORUS\Desktop\Work_Echart\EChartSimple\css\监控版\能源监控\企业监控\全区概况.css, CSS, 0, 0, 99, 0, 0, 14, 18, 131
c:\Users\AORUS\Desktop\Work_Echart\EChartSimple\css\监控版\能源监控\企业监控\区域用户分布占比.css, CSS, 0, 0, 16, 0, 0, 5, 10, 31
c:\Users\AORUS\Desktop\Work_Echart\EChartSimple\css\监控版\能源监控\企业监控\当日能耗-区域属性.css, CSS, 0, 0, 15, 0, 0, 9, 12, 36
c:\Users\AORUS\Desktop\Work_Echart\EChartSimple\css\监控版\能源监控\企业监控\当日能耗-设备属性.css, CSS, 0, 0, 15, 0, 0, 9, 12, 36
c:\Users\AORUS\Desktop\Work_Echart\EChartSimple\css\监控版\能源监控\企业监控\日月光半导体.css, CSS, 0, 0, 84, 0, 0, 6, 16, 106
c:\Users\AORUS\Desktop\Work_Echart\EChartSimple\css\监控版\能源监控\企业监控\本月用能趋势.css, CSS, 0, 0, 15, 0, 0, 9, 12, 36
c:\Users\AORUS\Desktop\Work_Echart\EChartSimple\css\监控版\能源监控\企业监控\行业用户分布占比.css, CSS, 0, 0, 83, 0, 0, 14, 14, 111
c:\Users\AORUS\Desktop\Work_Echart\EChartSimple\css\监控版\能源监控\全景分析\全区概况.css, CSS, 0, 0, 99, 0, 0, 14, 18, 131
c:\Users\AORUS\Desktop\Work_Echart\EChartSimple\css\监控版\能源监控\全景分析\区域用户分布占比.css, CSS, 0, 0, 16, 0, 0, 5, 10, 31
c:\Users\AORUS\Desktop\Work_Echart\EChartSimple\css\监控版\能源监控\全景分析\当月供需对比图.css, CSS, 0, 0, 46, 0, 0, 9, 19, 74
c:\Users\AORUS\Desktop\Work_Echart\EChartSimple\css\监控版\能源监控\全景分析\当月分区消费排名.css, CSS, 0, 0, 16, 0, 0, 6, 10, 32
c:\Users\AORUS\Desktop\Work_Echart\EChartSimple\css\监控版\能源监控\全景分析\当月能源消费重点监测.css, CSS, 0, 0, 46, 0, 0, 9, 19, 74
c:\Users\AORUS\Desktop\Work_Echart\EChartSimple\css\监控版\能源监控\全景分析\当月行业消费排名.css, CSS, 0, 0, 15, 0, 0, 4, 10, 29
c:\Users\AORUS\Desktop\Work_Echart\EChartSimple\css\监控版\能源监控\全景分析\行业用户分布占比.css, CSS, 0, 0, 83, 0, 0, 14, 15, 112
c:\Users\AORUS\Desktop\Work_Echart\EChartSimple\css\监控版\能源管理\base.css, CSS, 0, 0, 87, 0, 0, 27, 14, 128
c:\Users\AORUS\Desktop\Work_Echart\EChartSimple\css\监控版\能源管理\上海通用重工集团有限公司.css, CSS, 0, 0, 57, 0, 0, 15, 19, 91
c:\Users\AORUS\Desktop\Work_Echart\EChartSimple\css\监控版\能源管理\事件完成情况.css, CSS, 0, 0, 24, 0, 0, 10, 13, 47
c:\Users\AORUS\Desktop\Work_Echart\EChartSimple\css\监控版\能源管理\企业出力曲线 - 带标题.css, CSS, 0, 0, 21, 0, 0, 9, 13, 43
c:\Users\AORUS\Desktop\Work_Echart\EChartSimple\css\监控版\能源管理\企业出力曲线 - 纯图片.css, CSS, 0, 0, 16, 0, 0, 9, 15, 40
c:\Users\AORUS\Desktop\Work_Echart\EChartSimple\css\监控版\能源管理\企业出力曲线 - 表-纯图片.css, CSS, 0, 0, 16, 0, 0, 9, 15, 40
c:\Users\AORUS\Desktop\Work_Echart\EChartSimple\css\监控版\能源管理\企业出力曲线.css, CSS, 0, 0, 15, 0, 0, 9, 15, 39
c:\Users\AORUS\Desktop\Work_Echart\EChartSimple\css\监控版\能源管理\企业出力曲线数据绑定版_完结.css, CSS, 0, 0, 100, 0, 0, 11, 26, 137
c:\Users\AORUS\Desktop\Work_Echart\EChartSimple\css\监控版\能源管理\企业出力曲线数据绑定版_执行.css, CSS, 0, 0, 72, 0, 0, 21, 21, 114
c:\Users\AORUS\Desktop\Work_Echart\EChartSimple\css\监控版\能源管理\削峰填谷事件概览.css, CSS, 0, 0, 23, 0, 0, 11, 12, 46
c:\Users\AORUS\Desktop\Work_Echart\EChartSimple\css\监控版\能源管理\削峰填谷地图.css, CSS, 0, 0, 76, 0, 0, 13, 17, 106
c:\Users\AORUS\Desktop\Work_Echart\EChartSimple\css\监控版\能源管理\削峰填谷详情.css, CSS, 0, 0, 51, 0, 0, 13, 11, 75
c:\Users\AORUS\Desktop\Work_Echart\EChartSimple\css\监控版\能源管理\同意邀约企业.css, CSS, 0, 0, 64, 0, 0, 6, 10, 80
c:\Users\AORUS\Desktop\Work_Echart\EChartSimple\css\监控版\能源管理\完结-企业出力回顾.css, CSS, 0, 0, 57, 0, 0, 15, 20, 92
c:\Users\AORUS\Desktop\Work_Echart\EChartSimple\css\监控版\能源管理\实时全口径负荷.css, CSS, 0, 0, 15, 0, 0, 9, 15, 39
c:\Users\AORUS\Desktop\Work_Echart\EChartSimple\css\监控版\能源管理\底部切换.css, CSS, 0, 0, 23, 0, 0, 1, 5, 29
c:\Users\AORUS\Desktop\Work_Echart\EChartSimple\css\监控版\能源管理\待应答企业.css, CSS, 0, 0, 61, 0, 0, 5, 8, 74
c:\Users\AORUS\Desktop\Work_Echart\EChartSimple\css\监控版\能源管理\执行倒计时.css, CSS, 0, 0, 55, 0, 0, 3, 7, 65
c:\Users\AORUS\Desktop\Work_Echart\EChartSimple\css\监控版\能源管理\执行进度.css, CSS, 0, 0, 56, 0, 0, 30, 18, 104
c:\Users\AORUS\Desktop\Work_Echart\EChartSimple\css\监控版\能源管理\拒绝邀约企业.css, CSS, 0, 0, 69, 0, 0, 11, 14, 94
c:\Users\AORUS\Desktop\Work_Echart\EChartSimple\css\监控版\能源管理\时间轴.css, CSS, 0, 0, 171, 0, 0, 7, 25, 203
c:\Users\AORUS\Desktop\Work_Echart\EChartSimple\css\监控版\能源管理\最新削峰填谷事件.css, CSS, 0, 0, 69, 0, 0, 46, 22, 137
c:\Users\AORUS\Desktop\Work_Echart\EChartSimple\css\监控版\能源管理\线路实时态势 - 副本.css, CSS, 0, 0, 22, 0, 0, 5, 15, 42
c:\Users\AORUS\Desktop\Work_Echart\EChartSimple\css\监控版\能源管理\线路实时态势.css, CSS, 0, 0, 22, 0, 0, 5, 15, 42
c:\Users\AORUS\Desktop\Work_Echart\EChartSimple\css\监控版\能源管理\虚拟电厂出力曲线.css, CSS, 0, 0, 15, 0, 0, 9, 12, 36
c:\Users\AORUS\Desktop\Work_Echart\EChartSimple\css\监控版\能源管理\负载曲线.css, CSS, 0, 0, 15, 0, 0, 9, 12, 36
c:\Users\AORUS\Desktop\Work_Echart\EChartSimple\css\监控版\能源管理\邀约倒计时.css, CSS, 0, 0, 55, 0, 0, 3, 7, 65
c:\Users\AORUS\Desktop\Work_Echart\EChartSimple\css\监控版\能源管理\邀约进度.css, CSS, 0, 0, 53, 0, 0, 20, 17, 90
c:\Users\AORUS\Desktop\Work_Echart\EChartSimple\css\监控版\能源管理\高负载线路.css, CSS, 0, 0, 80, 0, 0, 33, 21, 134
c:\Users\AORUS\Desktop\Work_Echart\EChartSimple\css\监控版\驾驶舱\全区用能概况.css, CSS, 0, 0, 16, 0, 0, 5, 13, 34
c:\Users\AORUS\Desktop\Work_Echart\EChartSimple\css\监控版\驾驶舱\削峰填谷事件概览.css, CSS, 0, 0, 25, 0, 0, 5, 14, 44
c:\Users\AORUS\Desktop\Work_Echart\EChartSimple\css\监控版\驾驶舱\合同数量增长趋势.css, CSS, 0, 0, 15, 0, 0, 5, 10, 30
c:\Users\AORUS\Desktop\Work_Echart\EChartSimple\css\监控版\驾驶舱\最新削峰填谷事件.css, CSS, 0, 0, 75, 0, 0, 39, 31, 145
c:\Users\AORUS\Desktop\Work_Echart\EChartSimple\css\监控版\驾驶舱\最新异常事件.css, CSS, 0, 0, 77, 0, 0, 38, 31, 146
c:\Users\AORUS\Desktop\Work_Echart\EChartSimple\css\监控版\驾驶舱\服务概况-个性化定制服务.css, CSS, 0, 0, 33, 0, 0, 1, 13, 47
c:\Users\AORUS\Desktop\Work_Echart\EChartSimple\css\监控版\驾驶舱\服务概况-分析报告订单服务.css, CSS, 0, 0, 33, 0, 0, 0, 6, 39
c:\Users\AORUS\Desktop\Work_Echart\EChartSimple\css\监控版\驾驶舱\服务概况-数据接入服务.css, CSS, 0, 0, 33, 0, 0, 1, 11, 45
c:\Users\AORUS\Desktop\Work_Echart\EChartSimple\css\监控版\驾驶舱\本月异常用能事件.css, CSS, 0, 0, 108, 0, 0, 18, 26, 152
c:\Users\AORUS\Desktop\Work_Echart\EChartSimple\css\监控版\驾驶舱\标签云.css, CSS, 0, 0, 138, 0, 0, 18, 37, 193
c:\Users\AORUS\Desktop\Work_Echart\EChartSimple\css\监控版\驾驶舱\标签云_New.css, CSS, 0, 0, 56, 0, 0, 10, 28, 94
c:\Users\AORUS\Desktop\Work_Echart\EChartSimple\css\监控版\驾驶舱\标签全生命周期.css, CSS, 0, 0, 94, 0, 0, 1, 12, 107
c:\Users\AORUS\Desktop\Work_Echart\EChartSimple\css\监控版\驾驶舱\标签概况.css, CSS, 0, 0, 16, 0, 0, 5, 12, 33
c:\Users\AORUS\Desktop\Work_Echart\EChartSimple\css\监控版\驾驶舱\能源交易概况.css, CSS, 0, 0, 67, 0, 0, 21, 34, 122
c:\Users\AORUS\Desktop\Work_Echart\EChartSimple\css\监控版\驾驶舱\能源应用.css, CSS, 0, 0, 52, 0, 0, 4, 14, 70
c:\Users\AORUS\Desktop\Work_Echart\EChartSimple\css\监控版\驾驶舱\行业消费排名.css, CSS, 0, 0, 15, 0, 0, 5, 10, 30
c:\Users\AORUS\Desktop\Work_Echart\EChartSimple\css\监控版\驾驶舱\近30天供需对比.css, CSS, 0, 0, 17, 0, 0, 7, 10, 34
c:\Users\AORUS\Desktop\Work_Echart\EChartSimple\css\监控版\驾驶舱\近一年异常原因分析.css, CSS, 0, 0, 15, 0, 0, 5, 10, 30
c:\Users\AORUS\Desktop\Work_Echart\EChartSimple\css\监控版\驾驶舱\近一年异常原因分析b.css, CSS, 0, 0, 18, 0, 0, 5, 11, 34
c:\Users\AORUS\Desktop\Work_Echart\EChartSimple\css\监控版\驾驶舱\重点监控企业-能耗.css, CSS, 0, 0, 15, 0, 0, 6, 10, 31
c:\Users\AORUS\Desktop\Work_Echart\EChartSimple\css\监控版\驾驶舱\高负载线路.css, CSS, 0, 0, 75, 0, 0, 39, 31, 145
c:\Users\AORUS\Desktop\Work_Echart\EChartSimple\css\矩形树图.css, CSS, 0, 0, 36, 0, 0, 5, 1, 42
c:\Users\AORUS\Desktop\Work_Echart\EChartSimple\css\阴影文本.css, CSS, 0, 0, 11, 0, 0, 0, 1, 12
c:\Users\AORUS\Desktop\Work_Echart\EChartSimple\font_family\icomoon\icomoon.svg, XML, 29, 0, 0, 0, 0, 0, 2, 31
c:\Users\AORUS\Desktop\Work_Echart\EChartSimple\html\.vs\ProjectSettings.json, JSON, 0, 3, 0, 0, 0, 0, 0, 3
c:\Users\AORUS\Desktop\Work_Echart\EChartSimple\html\.vs\VSWorkspaceState.json, JSON, 0, 6, 0, 0, 0, 0, 0, 6
c:\Users\AORUS\Desktop\Work_Echart\EChartSimple\html\A_MainMenu_监控版.html, HTML, 0, 0, 0, 0, 26, 1, 7, 34
c:\Users\AORUS\Desktop\Work_Echart\EChartSimple\html\B_MainMenu_展示版.html, HTML, 0, 0, 0, 0, 23, 0, 5, 28
c:\Users\AORUS\Desktop\Work_Echart\EChartSimple\html\Histogram_1.html, HTML, 0, 0, 0, 0, 28, 1, 3, 32
c:\Users\AORUS\Desktop\Work_Echart\EChartSimple\html\Horizontal_histogram.html, HTML, 0, 0, 0, 0, 23, 0, 1, 24
c:\Users\AORUS\Desktop\Work_Echart\EChartSimple\html\MainMenu_nykhsj.html, HTML, 0, 0, 0, 0, 56, 0, 4, 60
c:\Users\AORUS\Desktop\Work_Echart\EChartSimple\html\NewTest (2).html, HTML, 0, 0, 0, 0, 305, 0, 20, 325
c:\Users\AORUS\Desktop\Work_Echart\EChartSimple\html\NewTest.html, HTML, 0, 0, 0, 0, 46, 0, 5, 51
c:\Users\AORUS\Desktop\Work_Echart\EChartSimple\html\Table.html, HTML, 0, 0, 0, 0, 20, 0, 1, 21
c:\Users\AORUS\Desktop\Work_Echart\EChartSimple\html\Tool\地区三级联动.html, HTML, 0, 0, 0, 0, 53, 0, 4, 57
c:\Users\AORUS\Desktop\Work_Echart\EChartSimple\html\Tool\地区三级联动展示版.html, HTML, 0, 0, 0, 0, 53, 0, 4, 57
c:\Users\AORUS\Desktop\Work_Echart\EChartSimple\html\Tool\导航小地图.html, HTML, 0, 0, 0, 0, 18, 0, 4, 22
c:\Users\AORUS\Desktop\Work_Echart\EChartSimple\html\Vertical_histogram.html, HTML, 0, 0, 0, 0, 24, 0, 1, 25
c:\Users\AORUS\Desktop\Work_Echart\EChartSimple\html\hotMap.html, HTML, 0, 0, 0, 0, 252, 0, 67, 319
c:\Users\AORUS\Desktop\Work_Echart\EChartSimple\html\line_chart.html, HTML, 0, 0, 0, 0, 23, 0, 1, 24
c:\Users\AORUS\Desktop\Work_Echart\EChartSimple\html\main.html, HTML, 0, 0, 0, 0, 52, 1, 4, 57
c:\Users\AORUS\Desktop\Work_Echart\EChartSimple\html\test.html, HTML, 0, 0, 0, 0, 16, 0, 4, 20
c:\Users\AORUS\Desktop\Work_Echart\EChartSimple\html\区域分析.html, HTML, 0, 0, 0, 0, 19, 1, 5, 25
c:\Users\AORUS\Desktop\Work_Echart\EChartSimple\html\客户特征分析.html, HTML, 0, 0, 0, 0, 23, 1, 5, 29
c:\Users\AORUS\Desktop\Work_Echart\EChartSimple\html\展示版\政府视角.html, HTML, 0, 0, 0, 0, 43, 1, 6, 50
c:\Users\AORUS\Desktop\Work_Echart\EChartSimple\html\展示版\政府视角\万元产值能耗.html, HTML, 0, 0, 0, 0, 28, 1, 5, 34
c:\Users\AORUS\Desktop\Work_Echart\EChartSimple\html\展示版\政府视角\企业异常用能事件.html, HTML, 0, 0, 0, 0, 25, 0, 5, 30
c:\Users\AORUS\Desktop\Work_Echart\EChartSimple\html\展示版\政府视角\企业概况.html, HTML, 0, 0, 0, 0, 23, 0, 5, 28
c:\Users\AORUS\Desktop\Work_Echart\EChartSimple\html\展示版\政府视角\企业能源消费排行.html, HTML, 0, 0, 0, 0, 29, 1, 5, 35
c:\Users\AORUS\Desktop\Work_Echart\EChartSimple\html\展示版\政府视角\区域概况.html, HTML, 0, 0, 0, 0, 28, 1, 5, 34
c:\Users\AORUS\Desktop\Work_Echart\EChartSimple\html\展示版\政府视角\区域能源消费比例.html, HTML, 0, 0, 0, 0, 28, 1, 5, 34
c:\Users\AORUS\Desktop\Work_Echart\EChartSimple\html\展示版\政府视角\区域能源消费结构.html, HTML, 0, 0, 0, 0, 28, 1, 5, 34
c:\Users\AORUS\Desktop\Work_Echart\EChartSimple\html\展示版\政府视角\单位面积能耗.html, HTML, 0, 0, 0, 0, 28, 1, 6, 35
c:\Users\AORUS\Desktop\Work_Echart\EChartSimple\html\展示版\政府视角\年度供需对比 copy.html, HTML, 0, 0, 0, 0, 28, 1, 5, 34
c:\Users\AORUS\Desktop\Work_Echart\EChartSimple\html\展示版\政府视角\年度供需对比.html, HTML, 0, 0, 0, 0, 28, 1, 5, 34
c:\Users\AORUS\Desktop\Work_Echart\EChartSimple\html\展示版\政府视角\年度综合能耗环比.html, HTML, 0, 0, 0, 0, 28, 1, 5, 34
c:\Users\AORUS\Desktop\Work_Echart\EChartSimple\html\展示版\政府视角\度电经济增加值.html, HTML, 0, 0, 0, 0, 28, 1, 5, 34
c:\Users\AORUS\Desktop\Work_Echart\EChartSimple\html\展示版\政府视角\异常用能原因.html, HTML, 0, 0, 0, 0, 28, 1, 5, 34
c:\Users\AORUS\Desktop\Work_Echart\EChartSimple\html\展示版\政府视角\异常能源监测.html, HTML, 0, 0, 0, 0, 28, 1, 5, 34
c:\Users\AORUS\Desktop\Work_Echart\EChartSimple\html\展示版\政府视角\最新异常事件.html, HTML, 0, 0, 0, 0, 25, 0, 5, 30
c:\Users\AORUS\Desktop\Work_Echart\EChartSimple\html\展示版\政府视角\有功图表x.html, HTML, 0, 0, 0, 0, 28, 1, 5, 34
c:\Users\AORUS\Desktop\Work_Echart\EChartSimple\html\展示版\政府视角\标签云.html, HTML, 0, 0, 0, 0, 29, 1, 4, 34
c:\Users\AORUS\Desktop\Work_Echart\EChartSimple\html\展示版\政府视角\清洁能源占比.html, HTML, 0, 0, 0, 0, 28, 1, 5, 34
c:\Users\AORUS\Desktop\Work_Echart\EChartSimple\html\展示版\政府视角\特征图表一.html, HTML, 0, 0, 0, 0, 28, 1, 5, 34
c:\Users\AORUS\Desktop\Work_Echart\EChartSimple\html\展示版\政府视角\特征图表三.html, HTML, 0, 0, 0, 0, 28, 1, 5, 34
c:\Users\AORUS\Desktop\Work_Echart\EChartSimple\html\展示版\政府视角\特征图表二.html, HTML, 0, 0, 0, 0, 28, 1, 5, 34
c:\Users\AORUS\Desktop\Work_Echart\EChartSimple\html\展示版\政府视角\碳排放.html, HTML, 0, 0, 0, 0, 28, 1, 5, 34
c:\Users\AORUS\Desktop\Work_Echart\EChartSimple\html\展示版\政府视角\综合能耗.html, HTML, 0, 0, 0, 0, 28, 1, 5, 34
c:\Users\AORUS\Desktop\Work_Echart\EChartSimple\html\展示版\政府视角\能效环比.html, HTML, 0, 0, 0, 0, 28, 1, 5, 34
c:\Users\AORUS\Desktop\Work_Echart\EChartSimple\html\展示版\政府视角\能级评价指标.html, HTML, 0, 0, 0, 0, 25, 2, 5, 32
c:\Users\AORUS\Desktop\Work_Echart\EChartSimple\html\展示版\政府视角\自我学习趋势图.html, HTML, 0, 0, 0, 0, 28, 1, 5, 34
c:\Users\AORUS\Desktop\Work_Echart\EChartSimple\html\展示版\政府视角\行业能源消费排行.html, HTML, 0, 0, 0, 0, 28, 1, 5, 34
c:\Users\AORUS\Desktop\Work_Echart\EChartSimple\html\展示版\能源企业视角.html, HTML, 0, 0, 0, 0, 32, 1, 5, 38
c:\Users\AORUS\Desktop\Work_Echart\EChartSimple\html\展示版\能源企业视角\事件概况.html, HTML, 0, 0, 0, 0, 24, 8, 5, 37
c:\Users\AORUS\Desktop\Work_Echart\EChartSimple\html\展示版\能源企业视角\削峰填谷事件回顾.html, HTML, 0, 0, 0, 0, 24, 0, 4, 28
c:\Users\AORUS\Desktop\Work_Echart\EChartSimple\html\展示版\能源企业视角\区域概况.html, HTML, 0, 0, 0, 0, 27, 1, 4, 32
c:\Users\AORUS\Desktop\Work_Echart\EChartSimple\html\展示版\能源企业视角\客户区域分析.html, HTML, 0, 0, 0, 0, 27, 1, 4, 32
c:\Users\AORUS\Desktop\Work_Echart\EChartSimple\html\展示版\能源企业视角\客户行业分析.html, HTML, 0, 0, 0, 0, 27, 1, 4, 32
c:\Users\AORUS\Desktop\Work_Echart\EChartSimple\html\展示版\能源企业视角\总响应量排行榜.html, HTML, 0, 0, 0, 0, 27, 42, 5, 74
c:\Users\AORUS\Desktop\Work_Echart\EChartSimple\html\展示版\能源企业视角\标签云.html, HTML, 0, 0, 0, 0, 29, 1, 4, 34
c:\Users\AORUS\Desktop\Work_Echart\EChartSimple\html\展示版\能源企业视角\标签云1.html, HTML, 0, 0, 0, 0, 30, 1, 4, 35
c:\Users\AORUS\Desktop\Work_Echart\EChartSimple\html\展示版\能源企业视角\线路负载率.html, HTML, 0, 0, 0, 0, 24, 0, 4, 28
c:\Users\AORUS\Desktop\Work_Echart\EChartSimple\html\展示版\能源企业视角\线路负载率对比.html, HTML, 0, 0, 0, 0, 27, 1, 4, 32
c:\Users\AORUS\Desktop\Work_Echart\EChartSimple\html\展示版\能源企业视角\虚拟电厂出力曲线.html, HTML, 0, 0, 0, 0, 27, 1, 4, 32
c:\Users\AORUS\Desktop\Work_Echart\EChartSimple\html\展示版\能源企业视角\虚拟电厂完结汇总.html, HTML, 0, 0, 0, 0, 27, 1, 4, 32
c:\Users\AORUS\Desktop\Work_Echart\EChartSimple\html\展示版\能源企业视角\近一年削峰填谷事件数量.html, HTML, 0, 0, 0, 0, 27, 1, 3, 31
c:\Users\AORUS\Desktop\Work_Echart\EChartSimple\html\展示版\能源企业视角\高-低负载线路.html, HTML, 0, 0, 0, 0, 25, 0, 4, 29
c:\Users\AORUS\Desktop\Work_Echart\EChartSimple\html\展示版\能源客户视角.html, HTML, 0, 0, 0, 0, 55, 0, 5, 60
c:\Users\AORUS\Desktop\Work_Echart\EChartSimple\html\展示版\能源客户视角\企业能效top20.html, HTML, 0, 0, 0, 0, 27, 1, 4, 32
c:\Users\AORUS\Desktop\Work_Echart\EChartSimple\html\展示版\能源客户视角\企业能耗top20.html, HTML, 0, 0, 0, 0, 27, 1, 4, 32
c:\Users\AORUS\Desktop\Work_Echart\EChartSimple\html\展示版\能源客户视角\出线柜.html, HTML, 0, 0, 0, 0, 24, 0, 4, 28
c:\Users\AORUS\Desktop\Work_Echart\EChartSimple\html\展示版\能源客户视角\功率因数行业排名.html, HTML, 0, 0, 0, 0, 29, 1, 4, 34
c:\Users\AORUS\Desktop\Work_Echart\EChartSimple\html\展示版\能源客户视角\功率因数详情.html, HTML, 0, 0, 0, 0, 24, 2, 4, 30
c:\Users\AORUS\Desktop\Work_Echart\EChartSimple\html\展示版\能源客户视角\区域概况.html, HTML, 0, 0, 0, 0, 27, 1, 4, 32
c:\Users\AORUS\Desktop\Work_Echart\EChartSimple\html\展示版\能源客户视角\去年电量构成-楼宇.html, HTML, 0, 0, 0, 0, 27, 1, 4, 32
c:\Users\AORUS\Desktop\Work_Echart\EChartSimple\html\展示版\能源客户视角\去年电量构成-电量峰谷.html, HTML, 0, 0, 0, 0, 29, 1, 5, 35
c:\Users\AORUS\Desktop\Work_Echart\EChartSimple\html\展示版\能源客户视角\变压器.html, HTML, 0, 0, 0, 0, 24, 0, 4, 28
c:\Users\AORUS\Desktop\Work_Echart\EChartSimple\html\展示版\能源客户视角\各月功率因数及力率奖惩电费.html, HTML, 0, 0, 0, 0, 27, 1, 4, 32
c:\Users\AORUS\Desktop\Work_Echart\EChartSimple\html\展示版\能源客户视角\各楼层功能.html, HTML, 0, 0, 0, 0, 24, 0, 4, 28
c:\Users\AORUS\Desktop\Work_Echart\EChartSimple\html\展示版\能源客户视角\各楼层能效.html, HTML, 0, 0, 0, 0, 27, 1, 4, 32
c:\Users\AORUS\Desktop\Work_Echart\EChartSimple\html\展示版\能源客户视角\各楼层能耗.html, HTML, 0, 0, 0, 0, 27, 1, 4, 32
c:\Users\AORUS\Desktop\Work_Echart\EChartSimple\html\展示版\能源客户视角\园区年度综合能耗环比.html, HTML, 0, 0, 0, 0, 27, 1, 4, 32
c:\Users\AORUS\Desktop\Work_Echart\EChartSimple\html\展示版\能源客户视角\园区楼宇能效_单位建筑面积能耗.html, HTML, 0, 0, 0, 0, 27, 1, 4, 32
c:\Users\AORUS\Desktop\Work_Echart\EChartSimple\html\展示版\能源客户视角\园区楼宇能耗排名.html, HTML, 0, 0, 0, 0, 27, 1, 4, 32
c:\Users\AORUS\Desktop\Work_Echart\EChartSimple\html\展示版\能源客户视角\园区能效top20.html, HTML, 0, 0, 0, 0, 27, 1, 4, 32
c:\Users\AORUS\Desktop\Work_Echart\EChartSimple\html\展示版\能源客户视角\园区能效环比.html, HTML, 0, 0, 0, 0, 27, 1, 4, 32
c:\Users\AORUS\Desktop\Work_Echart\EChartSimple\html\展示版\能源客户视角\园区能级评价指标.html, HTML, 0, 0, 0, 0, 24, 2, 4, 30
c:\Users\AORUS\Desktop\Work_Echart\EChartSimple\html\展示版\能源客户视角\园区能耗top20.html, HTML, 0, 0, 0, 0, 27, 1, 4, 32
c:\Users\AORUS\Desktop\Work_Echart\EChartSimple\html\展示版\能源客户视角\套管温度变化.html, HTML, 0, 0, 0, 0, 27, 1, 4, 32
c:\Users\AORUS\Desktop\Work_Echart\EChartSimple\html\展示版\能源客户视角\峰谷平电量占比与峰谷比.html, HTML, 0, 0, 0, 0, 27, 1, 4, 32
c:\Users\AORUS\Desktop\Work_Echart\EChartSimple\html\展示版\能源客户视角\年供需对比曲线.html, HTML, 0, 0, 0, 0, 27, 1, 4, 32
c:\Users\AORUS\Desktop\Work_Echart\EChartSimple\html\展示版\能源客户视角\年度综合能耗环比.html, HTML, 0, 0, 0, 0, 27, 1, 4, 32
c:\Users\AORUS\Desktop\Work_Echart\EChartSimple\html\展示版\能源客户视角\张江人工智能岛.html, HTML, 0, 0, 0, 0, 24, 2, 4, 30
c:\Users\AORUS\Desktop\Work_Echart\EChartSimple\html\展示版\能源客户视角\最大设备利用率.html, HTML, 0, 0, 0, 0, 27, 1, 4, 32
c:\Users\AORUS\Desktop\Work_Echart\EChartSimple\html\展示版\能源客户视角\最大设备利用率行业排名.html, HTML, 0, 0, 0, 0, 29, 1, 4, 34
c:\Users\AORUS\Desktop\Work_Echart\EChartSimple\html\展示版\能源客户视角\楼宇概况.html, HTML, 0, 0, 0, 0, 24, 2, 4, 30
c:\Users\AORUS\Desktop\Work_Echart\EChartSimple\html\展示版\能源客户视角\温度监测-红外图谱.html, HTML, 0, 0, 0, 0, 27, 1, 4, 32
c:\Users\AORUS\Desktop\Work_Echart\EChartSimple\html\展示版\能源客户视角\用电经济性指标同行对比.html, HTML, 0, 0, 0, 0, 27, 1, 4, 32
c:\Users\AORUS\Desktop\Work_Echart\EChartSimple\html\展示版\能源客户视角\电量峰谷比行业排名.html, HTML, 0, 0, 0, 0, 29, 1, 4, 34
c:\Users\AORUS\Desktop\Work_Echart\EChartSimple\html\展示版\能源客户视角\电量峰谷比详情.html, HTML, 0, 0, 0, 0, 24, 2, 4, 30
c:\Users\AORUS\Desktop\Work_Echart\EChartSimple\html\展示版\能源客户视角\能效环比.html, HTML, 0, 0, 0, 0, 27, 1, 4, 32
c:\Users\AORUS\Desktop\Work_Echart\EChartSimple\html\展示版\能源客户视角\能级评价指标.html, HTML, 0, 0, 0, 0, 24, 2, 4, 30
c:\Users\AORUS\Desktop\Work_Echart\EChartSimple\html\展示版\能源客户视角\计量柜.html, HTML, 0, 0, 0, 0, 24, 0, 4, 28
c:\Users\AORUS\Desktop\Work_Echart\EChartSimple\html\展示版\能源客户视角\设备利用率详情.html, HTML, 0, 0, 0, 0, 24, 2, 4, 30
c:\Users\AORUS\Desktop\Work_Echart\EChartSimple\html\展示版\能源客户视角\设备运行状况分析.html, HTML, 0, 0, 0, 0, 24, 2, 4, 30
c:\Users\AORUS\Desktop\Work_Echart\EChartSimple\html\展示版\能源客户视角\进线柜.html, HTML, 0, 0, 0, 0, 24, 0, 4, 28
c:\Users\AORUS\Desktop\Work_Echart\EChartSimple\html\展示版\能源服务市场.html, HTML, 0, 0, 0, 0, 35, 0, 7, 42
c:\Users\AORUS\Desktop\Work_Echart\EChartSimple\html\展示版\能源服务市场\产业联盟星级评定.html, HTML, 0, 0, 0, 0, 27, 1, 4, 32
c:\Users\AORUS\Desktop\Work_Echart\EChartSimple\html\展示版\能源服务市场\亿可能源服务公司.html, HTML, 0, 0, 0, 0, 29, 1, 4, 34
c:\Users\AORUS\Desktop\Work_Echart\EChartSimple\html\展示版\能源服务市场\企业标签云.html, HTML, 0, 0, 0, 0, 27, 1, 4, 32
c:\Users\AORUS\Desktop\Work_Echart\EChartSimple\html\展示版\能源服务市场\企业概况.html, HTML, 0, 0, 0, 0, 22, 0, 4, 26
c:\Users\AORUS\Desktop\Work_Echart\EChartSimple\html\展示版\能源服务市场\企业能耗.html, HTML, 0, 0, 0, 0, 27, 1, 4, 32
c:\Users\AORUS\Desktop\Work_Echart\EChartSimple\html\展示版\能源服务市场\区域概况.html, HTML, 0, 0, 0, 0, 27, 1, 4, 32
c:\Users\AORUS\Desktop\Work_Echart\EChartSimple\html\展示版\能源服务市场\历史评价.html, HTML, 0, 0, 0, 0, 125, 1, 4, 130
c:\Users\AORUS\Desktop\Work_Echart\EChartSimple\html\展示版\能源服务市场\各类商品成交趋势.html, HTML, 0, 0, 0, 0, 27, 1, 4, 32
c:\Users\AORUS\Desktop\Work_Echart\EChartSimple\html\展示版\能源服务市场\合同数量变化趋势.html, HTML, 0, 0, 0, 0, 27, 1, 4, 32
c:\Users\AORUS\Desktop\Work_Echart\EChartSimple\html\展示版\能源服务市场\客户区域分析.html, HTML, 0, 0, 0, 0, 27, 1, 4, 32
c:\Users\AORUS\Desktop\Work_Echart\EChartSimple\html\展示版\能源服务市场\客户行业分析.html, HTML, 0, 0, 0, 0, 29, 1, 4, 34
c:\Users\AORUS\Desktop\Work_Echart\EChartSimple\html\展示版\能源服务市场\客户行业分析_Old.html, HTML, 0, 0, 0, 0, 27, 1, 4, 32
c:\Users\AORUS\Desktop\Work_Echart\EChartSimple\html\展示版\能源服务市场\明星商品销量.html, HTML, 0, 0, 0, 0, 27, 1, 4, 32
c:\Users\AORUS\Desktop\Work_Echart\EChartSimple\html\展示版\能源服务市场\累计需求流失.html, HTML, 0, 0, 0, 0, 27, 1, 4, 32
c:\Users\AORUS\Desktop\Work_Echart\EChartSimple\html\展示版\能源服务市场\经营服务范围.html, HTML, 0, 0, 0, 0, 40, 1, 4, 45
c:\Users\AORUS\Desktop\Work_Echart\EChartSimple\html\展示版\能源服务市场\能效环比.html, HTML, 0, 0, 0, 0, 27, 1, 4, 32
c:\Users\AORUS\Desktop\Work_Echart\EChartSimple\html\展示版\能源服务市场\能源服务市场概括.html, HTML, 0, 0, 0, 0, 27, 1, 4, 32
c:\Users\AORUS\Desktop\Work_Echart\EChartSimple\html\展示版\能源服务市场\需求-商品成交分类占比.html, HTML, 0, 0, 0, 0, 27, 1, 4, 32
c:\Users\AORUS\Desktop\Work_Echart\EChartSimple\html\展示版\能源服务市场\需求-商品成交转换率.html, HTML, 0, 0, 0, 0, 24, 1, 4, 29
c:\Users\AORUS\Desktop\Work_Echart\EChartSimple\html\异常用能分析.html, HTML, 0, 0, 0, 0, 20, 1, 4, 25
c:\Users\AORUS\Desktop\Work_Echart\EChartSimple\html\控制版\main.html, HTML, 0, 0, 0, 0, 59, 0, 11, 70
c:\Users\AORUS\Desktop\Work_Echart\EChartSimple\html\控制版\交易总览.html, HTML, 0, 0, 0, 0, 18, 0, 4, 22
c:\Users\AORUS\Desktop\Work_Echart\EChartSimple\html\控制版\交易详情.html, HTML, 0, 0, 0, 0, 90, 0, 6, 96
c:\Users\AORUS\Desktop\Work_Echart\EChartSimple\html\控制版\区域分析.html, HTML, 0, 0, 0, 0, 18, 0, 4, 22
c:\Users\AORUS\Desktop\Work_Echart\EChartSimple\html\控制版\大屏首页.html, HTML, 0, 0, 0, 0, 18, 0, 4, 22
c:\Users\AORUS\Desktop\Work_Echart\EChartSimple\html\控制版\客户特征分析.html, HTML, 0, 0, 0, 0, 118, 0, 4, 122
c:\Users\AORUS\Desktop\Work_Echart\EChartSimple\html\控制版\异常用能分析.html, HTML, 0, 0, 0, 0, 41, 0, 5, 46
c:\Users\AORUS\Desktop\Work_Echart\EChartSimple\html\控制版\服务概况.html, HTML, 0, 0, 0, 0, 18, 0, 4, 22
c:\Users\AORUS\Desktop\Work_Echart\EChartSimple\html\控制版\服务详情.html, HTML, 0, 0, 0, 0, 119, 0, 4, 123
c:\Users\AORUS\Desktop\Work_Echart\EChartSimple\html\控制版\能源应用.html, HTML, 0, 0, 0, 0, 100, 0, 5, 105
c:\Users\AORUS\Desktop\Work_Echart\EChartSimple\html\控制版\能源监控.html, HTML, 0, 0, 0, 0, 18, 0, 4, 22
c:\Users\AORUS\Desktop\Work_Echart\EChartSimple\html\控制版\能源管理.html, HTML, 0, 0, 0, 0, 119, 0, 4, 123
c:\Users\AORUS\Desktop\Work_Echart\EChartSimple\html\测试.html, HTML, 0, 0, 0, 0, 320, 0, 22, 342
c:\Users\AORUS\Desktop\Work_Echart\EChartSimple\html\监控版\能源交易.html, HTML, 0, 0, 0, 0, 21, 1, 4, 26
c:\Users\AORUS\Desktop\Work_Echart\EChartSimple\html\监控版\能源交易\交易总览.html, HTML, 0, 0, 0, 0, 32, 1, 4, 37
c:\Users\AORUS\Desktop\Work_Echart\EChartSimple\html\监控版\能源交易\交易总览\各类商品成交趋势.html, HTML, 0, 0, 0, 0, 26, 1, 3, 30
c:\Users\AORUS\Desktop\Work_Echart\EChartSimple\html\监控版\能源交易\交易总览\商品成交分类占比.html, HTML, 0, 0, 0, 0, 26, 1, 4, 31
c:\Users\AORUS\Desktop\Work_Echart\EChartSimple\html\监控版\能源交易\交易总览\商品成交转换率.html, HTML, 0, 0, 0, 0, 23, 112, 4, 139
c:\Users\AORUS\Desktop\Work_Echart\EChartSimple\html\监控版\能源交易\交易总览\客户区域分析.html, HTML, 0, 0, 0, 0, 26, 1, 4, 31
c:\Users\AORUS\Desktop\Work_Echart\EChartSimple\html\监控版\能源交易\交易总览\客户行业分布占比.html, HTML, 0, 0, 0, 0, 28, 1, 4, 33
c:\Users\AORUS\Desktop\Work_Echart\EChartSimple\html\监控版\能源交易\交易总览\搁置需求列表.html, HTML, 0, 0, 0, 0, 23, 0, 4, 27
c:\Users\AORUS\Desktop\Work_Echart\EChartSimple\html\监控版\能源交易\交易总览\明星商品销量.html, HTML, 0, 0, 0, 0, 27, 1, 4, 32
c:\Users\AORUS\Desktop\Work_Echart\EChartSimple\html\监控版\能源交易\交易总览\累计需求流失分类占比.html, HTML, 0, 0, 0, 0, 26, 1, 4, 31
c:\Users\AORUS\Desktop\Work_Echart\EChartSimple\html\监控版\能源交易\交易总览\能源交易左侧图元.html, HTML, 0, 0, 0, 0, 26, 1, 4, 31
c:\Users\AORUS\Desktop\Work_Echart\EChartSimple\html\监控版\能源交易\交易总览\能源服务商列表.html, HTML, 0, 0, 0, 0, 47, 0, 4, 51
c:\Users\AORUS\Desktop\Work_Echart\EChartSimple\html\监控版\能源交易\交易总览\评分占比.html, HTML, 0, 0, 0, 0, 26, 1, 4, 31
c:\Users\AORUS\Desktop\Work_Echart\EChartSimple\html\监控版\能源交易\交易总览\需求成交分类占比.html, HTML, 0, 0, 0, 0, 26, 1, 4, 31
c:\Users\AORUS\Desktop\Work_Echart\EChartSimple\html\监控版\能源交易\交易总览\需求成交转换率.html, HTML, 0, 0, 0, 0, 23, 112, 4, 139
c:\Users\AORUS\Desktop\Work_Echart\EChartSimple\html\监控版\能源交易\交易详情.html, HTML, 0, 0, 0, 0, 30, 1, 4, 35
c:\Users\AORUS\Desktop\Work_Echart\EChartSimple\html\监控版\能源交易\交易详情\上海日月光半导体公司.html, HTML, 0, 0, 0, 0, 26, 0, 7, 33
c:\Users\AORUS\Desktop\Work_Echart\EChartSimple\html\监控版\能源交易\交易详情\企业简介.html, HTML, 0, 0, 0, 0, 24, 0, 5, 29
c:\Users\AORUS\Desktop\Work_Echart\EChartSimple\html\监控版\能源交易\交易详情\合同评价.html, HTML, 0, 0, 0, 0, 24, 0, 5, 29
c:\Users\AORUS\Desktop\Work_Echart\EChartSimple\html\监控版\能源交易\交易详情\商品交易概况.html, HTML, 0, 0, 0, 0, 27, 1, 4, 32
c:\Users\AORUS\Desktop\Work_Echart\EChartSimple\html\监控版\能源交易\交易详情\商品信息.html, HTML, 0, 0, 0, 0, 26, 0, 6, 32
c:\Users\AORUS\Desktop\Work_Echart\EChartSimple\html\监控版\能源交易\交易详情\商品订单数量曲线.html, HTML, 0, 0, 0, 0, 26, 1, 3, 30
c:\Users\AORUS\Desktop\Work_Echart\EChartSimple\html\监控版\能源交易\交易详情\商品详情列表.html, HTML, 0, 0, 0, 0, 25, 0, 4, 29
c:\Users\AORUS\Desktop\Work_Echart\EChartSimple\html\监控版\能源交易\交易详情\设备购买合同.html, HTML, 0, 0, 0, 0, 19, 0, 3, 22
c:\Users\AORUS\Desktop\Work_Echart\EChartSimple\html\监控版\能源交易\交易详情\需求方-上海通用重工.html, HTML, 0, 0, 0, 0, 23, 0, 5, 28
c:\Users\AORUS\Desktop\Work_Echart\EChartSimple\html\监控版\能源交易\交易详情\需求方.html, HTML, 0, 0, 0, 0, 24, 14, 5, 43
c:\Users\AORUS\Desktop\Work_Echart\EChartSimple\html\监控版\能源交易\交易详情\需求详情列表.html, HTML, 0, 0, 0, 0, 25, 0, 4, 29
c:\Users\AORUS\Desktop\Work_Echart\EChartSimple\html\监控版\能源分析.html, HTML, 0, 0, 0, 0, 23, 1, 4, 28
c:\Users\AORUS\Desktop\Work_Echart\EChartSimple\html\监控版\能源分析\企业分析.html, HTML, 0, 0, 0, 0, 29, 1, 4, 34
c:\Users\AORUS\Desktop\Work_Echart\EChartSimple\html\监控版\能源分析\企业分析\企业能耗综合分析.html, HTML, 0, 0, 0, 0, 27, 1, 3, 31
c:\Users\AORUS\Desktop\Work_Echart\EChartSimple\html\监控版\能源分析\企业分析\功率因数趋势.html, HTML, 0, 0, 0, 0, 27, 1, 4, 32
c:\Users\AORUS\Desktop\Work_Echart\EChartSimple\html\监控版\能源分析\企业分析\区域用能对比.html, HTML, 0, 0, 0, 0, 27, 1, 4, 32
c:\Users\AORUS\Desktop\Work_Echart\EChartSimple\html\监控版\能源分析\企业分析\单位面积能耗趋势.html, HTML, 0, 0, 0, 0, 27, 1, 4, 32
c:\Users\AORUS\Desktop\Work_Echart\EChartSimple\html\监控版\能源分析\企业分析\度电经济产值趋势.html, HTML, 0, 0, 0, 0, 27, 1, 4, 32
c:\Users\AORUS\Desktop\Work_Echart\EChartSimple\html\监控版\能源分析\企业分析\月度区域用能分析.html, HTML, 0, 0, 0, 0, 27, 1, 4, 32
c:\Users\AORUS\Desktop\Work_Echart\EChartSimple\html\监控版\能源分析\企业分析\月度设备用能分析.html, HTML, 0, 0, 0, 0, 27, 1, 4, 32
c:\Users\AORUS\Desktop\Work_Echart\EChartSimple\html\监控版\能源分析\企业分析\碳排放趋势.html, HTML, 0, 0, 0, 0, 27, 1, 4, 32
c:\Users\AORUS\Desktop\Work_Echart\EChartSimple\html\监控版\能源分析\企业分析\综合能耗同比环比对比.html, HTML, 0, 0, 0, 0, 27, 1, 4, 32
c:\Users\AORUS\Desktop\Work_Echart\EChartSimple\html\监控版\能源分析\企业分析\设备用能对比.html, HTML, 0, 0, 0, 0, 27, 1, 4, 32
c:\Users\AORUS\Desktop\Work_Echart\EChartSimple\html\监控版\能源分析\区域分析.html, HTML, 0, 0, 0, 0, 29, 1, 4, 34
c:\Users\AORUS\Desktop\Work_Echart\EChartSimple\html\监控版\能源分析\区域分析\产业能源消费占比.html, HTML, 0, 0, 0, 0, 26, 1, 4, 31
c:\Users\AORUS\Desktop\Work_Echart\EChartSimple\html\监控版\能源分析\区域分析\区域概况.html, HTML, 0, 0, 0, 0, 26, 10, 4, 40
c:\Users\AORUS\Desktop\Work_Echart\EChartSimple\html\监控版\能源分析\区域分析\各区域碳排放.html, HTML, 0, 0, 0, 0, 26, 1, 4, 31
c:\Users\AORUS\Desktop\Work_Echart\EChartSimple\html\监控版\能源分析\区域分析\各区域综合能耗.html, HTML, 0, 0, 0, 0, 26, 1, 4, 31
c:\Users\AORUS\Desktop\Work_Echart\EChartSimple\html\监控版\能源分析\区域分析\各区能效.html, HTML, 0, 0, 0, 0, 26, 1, 4, 31
c:\Users\AORUS\Desktop\Work_Echart\EChartSimple\html\监控版\能源分析\区域分析\各行业万元产值能耗.html, HTML, 0, 0, 0, 0, 26, 1, 4, 31
c:\Users\AORUS\Desktop\Work_Echart\EChartSimple\html\监控版\能源分析\区域分析\各行业综合能耗.html, HTML, 0, 0, 0, 0, 26, 1, 4, 31
c:\Users\AORUS\Desktop\Work_Echart\EChartSimple\html\监控版\能源分析\区域分析\行业能源消费占比.html, HTML, 0, 0, 0, 0, 28, 1, 4, 33
c:\Users\AORUS\Desktop\Work_Echart\EChartSimple\html\监控版\能源分析\区域分析\近30天耗能趋势.html, HTML, 0, 0, 0, 0, 26, 1, 4, 31
c:\Users\AORUS\Desktop\Work_Echart\EChartSimple\html\监控版\能源分析\区域分析\重点企业监控能耗.html, HTML, 0, 0, 0, 0, 26, 1, 3, 30
c:\Users\AORUS\Desktop\Work_Echart\EChartSimple\html\监控版\能源分析\客户特征分析.html, HTML, 0, 0, 0, 0, 26, 1, 4, 31
c:\Users\AORUS\Desktop\Work_Echart\EChartSimple\html\监控版\能源分析\客户特征分析\企业标签演变趋势.html, HTML, 0, 0, 0, 0, 26, 1, 4, 31
c:\Users\AORUS\Desktop\Work_Echart\EChartSimple\html\监控版\能源分析\客户特征分析\企业概况.html, HTML, 0, 0, 0, 0, 24, 2, 4, 30
c:\Users\AORUS\Desktop\Work_Echart\EChartSimple\html\监控版\能源分析\客户特征分析\客户特征分析地图.html, HTML, 0, 0, 0, 0, 26, 35, 5, 66
c:\Users\AORUS\Desktop\Work_Echart\EChartSimple\html\监控版\能源分析\客户特征分析\标签企业列表.html, HTML, 0, 0, 0, 0, 28, 21, 4, 53
c:\Users\AORUS\Desktop\Work_Echart\EChartSimple\html\监控版\能源分析\客户特征分析\标签分类占比.html, HTML, 0, 0, 0, 0, 26, 0, 6, 32
c:\Users\AORUS\Desktop\Work_Echart\EChartSimple\html\监控版\能源分析\客户特征分析\标签概况.html, HTML, 0, 0, 0, 0, 29, 1, 5, 35
c:\Users\AORUS\Desktop\Work_Echart\EChartSimple\html\监控版\能源分析\客户特征分析\标签调用排行.html, HTML, 0, 0, 0, 0, 25, 0, 7, 32
c:\Users\AORUS\Desktop\Work_Echart\EChartSimple\html\监控版\能源分析\异常用能分析\人工复检结果.html, HTML, 0, 0, 0, 0, 24, 64, 4, 92
c:\Users\AORUS\Desktop\Work_Echart\EChartSimple\html\监控版\能源分析\异常用能分析\企业异常事件.html, HTML, 0, 0, 0, 0, 24, 0, 4, 28
c:\Users\AORUS\Desktop\Work_Echart\EChartSimple\html\监控版\能源分析\异常用能分析\企业标签.html, HTML, 0, 0, 0, 0, 25, 13, 6, 44
c:\Users\AORUS\Desktop\Work_Echart\EChartSimple\html\监控版\能源分析\异常用能分析\区域异常排名.html, HTML, 0, 0, 0, 0, 27, 1, 4, 32
c:\Users\AORUS\Desktop\Work_Echart\EChartSimple\html\监控版\能源分析\异常用能分析\年度异常原因变化分析.html, HTML, 0, 0, 0, 0, 27, 1, 3, 31
c:\Users\AORUS\Desktop\Work_Echart\EChartSimple\html\监控版\能源分析\异常用能分析\异常事件列表.html, HTML, 0, 0, 0, 0, 24, 0, 3, 27
c:\Users\AORUS\Desktop\Work_Echart\EChartSimple\html\监控版\能源分析\异常用能分析\异常事件详情.html, HTML, 0, 0, 0, 0, 27, 1, 4, 32
c:\Users\AORUS\Desktop\Work_Echart\EChartSimple\html\监控版\能源分析\异常用能分析\异常原因AI判断.html, HTML, 0, 0, 0, 0, 27, 1, 4, 32
c:\Users\AORUS\Desktop\Work_Echart\EChartSimple\html\监控版\能源分析\异常用能分析\本月异常.html, HTML, 0, 0, 0, 0, 27, 1, 4, 32
c:\Users\AORUS\Desktop\Work_Echart\EChartSimple\html\监控版\能源分析\异常用能分析\行业异常排名.html, HTML, 0, 0, 0, 0, 27, 1, 3, 31
c:\Users\AORUS\Desktop\Work_Echart\EChartSimple\html\监控版\能源分析\异常用能分析\预判准确率趋势.html, HTML, 0, 0, 0, 0, 27, 1, 3, 31
c:\Users\AORUS\Desktop\Work_Echart\EChartSimple\html\监控版\能源分析\异常用能源分析.html, HTML, 0, 0, 0, 0, 30, 1, 4, 35
c:\Users\AORUS\Desktop\Work_Echart\EChartSimple\html\监控版\能源应用.html, HTML, 0, 0, 0, 0, 32, 1, 5, 38
c:\Users\AORUS\Desktop\Work_Echart\EChartSimple\html\监控版\能源应用\专家入驻趋势.html, HTML, 0, 0, 0, 0, 26, 1, 4, 31
c:\Users\AORUS\Desktop\Work_Echart\EChartSimple\html\监控版\能源应用\专家排行.html, HTML, 0, 0, 0, 0, 31, 0, 4, 35
c:\Users\AORUS\Desktop\Work_Echart\EChartSimple\html\监控版\能源应用\优秀成果及孵化项目.html, HTML, 0, 0, 0, 0, 26, 1, 4, 31
c:\Users\AORUS\Desktop\Work_Echart\EChartSimple\html\监控版\能源应用\各类金融类排行.html, HTML, 0, 0, 0, 0, 28, 0, 4, 32
c:\Users\AORUS\Desktop\Work_Echart\EChartSimple\html\监控版\能源应用\合同数量增长趋势.html, HTML, 0, 0, 0, 0, 26, 1, 4, 31
c:\Users\AORUS\Desktop\Work_Echart\EChartSimple\html\监控版\能源应用\成功案例建设趋势.html, HTML, 0, 0, 0, 0, 26, 1, 4, 31
c:\Users\AORUS\Desktop\Work_Echart\EChartSimple\html\监控版\能源应用\成功案例排行.html, HTML, 0, 0, 0, 0, 27, 0, 4, 31
c:\Users\AORUS\Desktop\Work_Echart\EChartSimple\html\监控版\能源应用\最新事件列表.html, HTML, 0, 0, 0, 0, 23, 0, 4, 27
c:\Users\AORUS\Desktop\Work_Echart\EChartSimple\html\监控版\能源应用\能源俱乐部事件排行.html, HTML, 0, 0, 0, 0, 30, 0, 4, 34
c:\Users\AORUS\Desktop\Work_Echart\EChartSimple\html\监控版\能源应用\能源俱乐部类型分类.html, HTML, 0, 0, 0, 0, 26, 1, 4, 31
c:\Users\AORUS\Desktop\Work_Echart\EChartSimple\html\监控版\能源应用\金融产品接入趋势.html, HTML, 0, 0, 0, 0, 26, 1, 4, 31
c:\Users\AORUS\Desktop\Work_Echart\EChartSimple\html\监控版\能源应用\金融渠道类型分布.html, HTML, 0, 0, 0, 0, 26, 1, 4, 31
c:\Users\AORUS\Desktop\Work_Echart\EChartSimple\html\监控版\能源应用\领域入驻专家.html, HTML, 0, 0, 0, 0, 26, 1, 4, 31
c:\Users\AORUS\Desktop\Work_Echart\EChartSimple\html\监控版\能源服务.html, HTML, 0, 0, 0, 0, 53, 1, 7, 61
c:\Users\AORUS\Desktop\Work_Echart\EChartSimple\html\监控版\能源服务\定制服务-区域对比.html, HTML, 0, 0, 0, 0, 27, 1, 4, 32
c:\Users\AORUS\Desktop\Work_Echart\EChartSimple\html\监控版\能源服务\定制服务-行业对比.html, HTML, 0, 0, 0, 0, 26, 1, 4, 31
c:\Users\AORUS\Desktop\Work_Echart\EChartSimple\html\监控版\能源服务\定制服务-订单状态.html, HTML, 0, 0, 0, 0, 25, 0, 5, 30
c:\Users\AORUS\Desktop\Work_Echart\EChartSimple\html\监控版\能源服务\定制服务.html, HTML, 0, 0, 0, 0, 23, 0, 4, 27
c:\Users\AORUS\Desktop\Work_Echart\EChartSimple\html\监控版\能源服务\定制服务列表.html, HTML, 0, 0, 0, 0, 23, 0, 4, 27
c:\Users\AORUS\Desktop\Work_Echart\EChartSimple\html\监控版\能源服务\定制服务消费月排行.html, HTML, 0, 0, 0, 0, 23, 0, 4, 27
c:\Users\AORUS\Desktop\Work_Echart\EChartSimple\html\监控版\能源服务\定制服务用户历史订单.html, HTML, 0, 0, 0, 0, 23, 0, 4, 27
c:\Users\AORUS\Desktop\Work_Echart\EChartSimple\html\监控版\能源服务\定制服务类型分布.html, HTML, 0, 0, 0, 0, 26, 1, 4, 31
c:\Users\AORUS\Desktop\Work_Echart\EChartSimple\html\监控版\能源服务\定制服务订单成果.html, HTML, 0, 0, 0, 0, 23, 0, 4, 27
c:\Users\AORUS\Desktop\Work_Echart\EChartSimple\html\监控版\能源服务\定制服务详情.html, HTML, 0, 0, 0, 0, 19, 43, 4, 66
c:\Users\AORUS\Desktop\Work_Echart\EChartSimple\html\监控版\能源服务\定制服务趋势.html, HTML, 0, 0, 0, 0, 26, 1, 4, 31
c:\Users\AORUS\Desktop\Work_Echart\EChartSimple\html\监控版\能源服务\报告订单服务-区域对比.html, HTML, 0, 0, 0, 0, 27, 1, 4, 32
c:\Users\AORUS\Desktop\Work_Echart\EChartSimple\html\监控版\能源服务\报告订单服务-行业对比.html, HTML, 0, 0, 0, 0, 26, 1, 4, 31
c:\Users\AORUS\Desktop\Work_Echart\EChartSimple\html\监控版\能源服务\报告订单服务-订单状态.html, HTML, 0, 0, 0, 0, 25, 0, 5, 30
c:\Users\AORUS\Desktop\Work_Echart\EChartSimple\html\监控版\能源服务\报告订单服务.html, HTML, 0, 0, 0, 0, 23, 0, 4, 27
c:\Users\AORUS\Desktop\Work_Echart\EChartSimple\html\监控版\能源服务\报告订单服务列表.html, HTML, 0, 0, 0, 0, 23, 0, 4, 27
c:\Users\AORUS\Desktop\Work_Echart\EChartSimple\html\监控版\能源服务\报告订单服务消费月排行.html, HTML, 0, 0, 0, 0, 23, 0, 4, 27
c:\Users\AORUS\Desktop\Work_Echart\EChartSimple\html\监控版\能源服务\报告订单服务用户历史订单.html, HTML, 0, 0, 0, 0, 23, 0, 4, 27
c:\Users\AORUS\Desktop\Work_Echart\EChartSimple\html\监控版\能源服务\报告订单服务类型分布.html, HTML, 0, 0, 0, 0, 26, 1, 4, 31
c:\Users\AORUS\Desktop\Work_Echart\EChartSimple\html\监控版\能源服务\报告订单服务订单成果.html, HTML, 0, 0, 0, 0, 23, 0, 4, 27
c:\Users\AORUS\Desktop\Work_Echart\EChartSimple\html\监控版\能源服务\报告订单服务详情.html, HTML, 0, 0, 0, 0, 19, 43, 4, 66
c:\Users\AORUS\Desktop\Work_Echart\EChartSimple\html\监控版\能源服务\报告订单服务趋势.html, HTML, 0, 0, 0, 0, 26, 1, 4, 31
c:\Users\AORUS\Desktop\Work_Echart\EChartSimple\html\监控版\能源服务\接入详情.html, HTML, 0, 0, 0, 0, 23, 0, 4, 27
c:\Users\AORUS\Desktop\Work_Echart\EChartSimple\html\监控版\能源服务\数据接入服务-区域对比.html, HTML, 0, 0, 0, 0, 27, 1, 4, 32
c:\Users\AORUS\Desktop\Work_Echart\EChartSimple\html\监控版\能源服务\数据接入服务-行业对比.html, HTML, 0, 0, 0, 0, 26, 1, 4, 31
c:\Users\AORUS\Desktop\Work_Echart\EChartSimple\html\监控版\能源服务\数据接入服务-订单状态.html, HTML, 0, 0, 0, 0, 25, 0, 5, 30
c:\Users\AORUS\Desktop\Work_Echart\EChartSimple\html\监控版\能源服务\数据接入服务.html, HTML, 0, 0, 0, 0, 23, 1, 4, 28
c:\Users\AORUS\Desktop\Work_Echart\EChartSimple\html\监控版\能源服务\数据接入服务列表.html, HTML, 0, 0, 0, 0, 23, 0, 4, 27
c:\Users\AORUS\Desktop\Work_Echart\EChartSimple\html\监控版\能源服务\数据接入服务类型分布.html, HTML, 0, 0, 0, 0, 26, 1, 4, 31
c:\Users\AORUS\Desktop\Work_Echart\EChartSimple\html\监控版\能源服务\数据接入服务详情.html, HTML, 0, 0, 0, 0, 19, 43, 4, 66
c:\Users\AORUS\Desktop\Work_Echart\EChartSimple\html\监控版\能源服务\数据接入服务趋势.html, HTML, 0, 0, 0, 0, 26, 1, 4, 31
c:\Users\AORUS\Desktop\Work_Echart\EChartSimple\html\监控版\能源服务\最新接入企业.html, HTML, 0, 0, 0, 0, 23, 0, 4, 27
c:\Users\AORUS\Desktop\Work_Echart\EChartSimple\html\监控版\能源服务\服务数量年度对比.html, HTML, 0, 0, 0, 0, 28, 1, 4, 33
c:\Users\AORUS\Desktop\Work_Echart\EChartSimple\html\监控版\能源服务\服务金额年度对比.html, HTML, 0, 0, 0, 0, 28, 1, 4, 33
c:\Users\AORUS\Desktop\Work_Echart\EChartSimple\html\监控版\能源监控.html, HTML, 0, 0, 0, 0, 21, 1, 4, 26
c:\Users\AORUS\Desktop\Work_Echart\EChartSimple\html\监控版\能源监控\企业监控.html, HTML, 0, 0, 0, 0, 27, 1, 5, 33
c:\Users\AORUS\Desktop\Work_Echart\EChartSimple\html\监控版\能源监控\企业监控\企业用能结构.html, HTML, 0, 0, 0, 0, 26, 1, 4, 31
c:\Users\AORUS\Desktop\Work_Echart\EChartSimple\html\监控版\能源监控\企业监控\全区概况.html, HTML, 0, 0, 0, 0, 27, 1, 6, 34
c:\Users\AORUS\Desktop\Work_Echart\EChartSimple\html\监控版\能源监控\企业监控\区域用户分布占比.html, HTML, 0, 0, 0, 0, 26, 1, 4, 31
c:\Users\AORUS\Desktop\Work_Echart\EChartSimple\html\监控版\能源监控\企业监控\当日能耗-区域属性.html, HTML, 0, 0, 0, 0, 26, 1, 3, 30
c:\Users\AORUS\Desktop\Work_Echart\EChartSimple\html\监控版\能源监控\企业监控\当日能耗-设备属性.html, HTML, 0, 0, 0, 0, 26, 1, 3, 30
c:\Users\AORUS\Desktop\Work_Echart\EChartSimple\html\监控版\能源监控\企业监控\日月光半导体.html, HTML, 0, 0, 0, 0, 23, 1, 1, 25
c:\Users\AORUS\Desktop\Work_Echart\EChartSimple\html\监控版\能源监控\企业监控\本月用能趋势.html, HTML, 0, 0, 0, 0, 26, 1, 3, 30
c:\Users\AORUS\Desktop\Work_Echart\EChartSimple\html\监控版\能源监控\企业监控\行业用户分布占比.html, HTML, 0, 0, 0, 0, 27, 0, 5, 32
c:\Users\AORUS\Desktop\Work_Echart\EChartSimple\html\监控版\能源监控\全景监控.html, HTML, 0, 0, 0, 0, 26, 1, 6, 33
c:\Users\AORUS\Desktop\Work_Echart\EChartSimple\html\监控版\能源监控\全景监控\全区概况.html, HTML, 0, 0, 0, 0, 27, 1, 6, 34
c:\Users\AORUS\Desktop\Work_Echart\EChartSimple\html\监控版\能源监控\全景监控\区域用户分布占比.html, HTML, 0, 0, 0, 0, 26, 1, 4, 31
c:\Users\AORUS\Desktop\Work_Echart\EChartSimple\html\监控版\能源监控\全景监控\当月供需对比图.html, HTML, 0, 0, 0, 0, 26, 1, 4, 31
c:\Users\AORUS\Desktop\Work_Echart\EChartSimple\html\监控版\能源监控\全景监控\当月分区消费排名.html, HTML, 0, 0, 0, 0, 26, 1, 4, 31
c:\Users\AORUS\Desktop\Work_Echart\EChartSimple\html\监控版\能源监控\全景监控\当月能源消费重点监测.html, HTML, 0, 0, 0, 0, 26, 1, 4, 31
c:\Users\AORUS\Desktop\Work_Echart\EChartSimple\html\监控版\能源监控\全景监控\当月行业消费排名.html, HTML, 0, 0, 0, 0, 26, 1, 4, 31
c:\Users\AORUS\Desktop\Work_Echart\EChartSimple\html\监控版\能源监控\全景监控\行业用户分布占比.html, HTML, 0, 0, 0, 0, 26, 1, 4, 31
c:\Users\AORUS\Desktop\Work_Echart\EChartSimple\html\监控版\能源管理.html, HTML, 0, 0, 0, 0, 46, 1, 5, 52
c:\Users\AORUS\Desktop\Work_Echart\EChartSimple\html\监控版\能源管理\上海通用重工集团有限公司.html, HTML, 0, 0, 0, 0, 31, 1, 4, 36
c:\Users\AORUS\Desktop\Work_Echart\EChartSimple\html\监控版\能源管理\事件完成情况.html, HTML, 0, 0, 0, 0, 27, 1, 4, 32
c:\Users\AORUS\Desktop\Work_Echart\EChartSimple\html\监控版\能源管理\企业出力曲线-带标题.html, HTML, 0, 0, 0, 0, 30, 1, 4, 35
c:\Users\AORUS\Desktop\Work_Echart\EChartSimple\html\监控版\能源管理\企业出力曲线-纯图片.html, HTML, 0, 0, 0, 0, 31, 1, 4, 36
c:\Users\AORUS\Desktop\Work_Echart\EChartSimple\html\监控版\能源管理\企业出力曲线-表-纯图片.html, HTML, 0, 0, 0, 0, 31, 1, 4, 36
c:\Users\AORUS\Desktop\Work_Echart\EChartSimple\html\监控版\能源管理\企业出力曲线.html, HTML, 0, 0, 0, 0, 27, 1, 5, 33
c:\Users\AORUS\Desktop\Work_Echart\EChartSimple\html\监控版\能源管理\企业出力曲线数据绑定版_完结.html, HTML, 0, 0, 0, 0, 26, 0, 4, 30
c:\Users\AORUS\Desktop\Work_Echart\EChartSimple\html\监控版\能源管理\企业出力曲线数据绑定版_执行.html, HTML, 0, 0, 0, 0, 28, 0, 4, 32
c:\Users\AORUS\Desktop\Work_Echart\EChartSimple\html\监控版\能源管理\削峰填谷事件概览.html, HTML, 0, 0, 0, 0, 27, 1, 4, 32
c:\Users\AORUS\Desktop\Work_Echart\EChartSimple\html\监控版\能源管理\削峰填谷地图.html, HTML, 0, 0, 0, 0, 47, 0, 5, 52
c:\Users\AORUS\Desktop\Work_Echart\EChartSimple\html\监控版\能源管理\削峰填谷详情.html, HTML, 0, 0, 0, 0, 24, 1, 6, 31
c:\Users\AORUS\Desktop\Work_Echart\EChartSimple\html\监控版\能源管理\同意邀约企业.html, HTML, 0, 0, 0, 0, 26, 1, 5, 32
c:\Users\AORUS\Desktop\Work_Echart\EChartSimple\html\监控版\能源管理\完结-企业出力回顾.html, HTML, 0, 0, 0, 0, 31, 1, 4, 36
c:\Users\AORUS\Desktop\Work_Echart\EChartSimple\html\监控版\能源管理\实时全口径负荷.html, HTML, 0, 0, 0, 0, 27, 1, 4, 32
c:\Users\AORUS\Desktop\Work_Echart\EChartSimple\html\监控版\能源管理\底部切换.html, HTML, 0, 0, 0, 0, 29, 0, 4, 33
c:\Users\AORUS\Desktop\Work_Echart\EChartSimple\html\监控版\能源管理\待应答企业.html, HTML, 0, 0, 0, 0, 26, 1, 5, 32
c:\Users\AORUS\Desktop\Work_Echart\EChartSimple\html\监控版\能源管理\执行倒计时.html, HTML, 0, 0, 0, 0, 38, 0, 4, 42
c:\Users\AORUS\Desktop\Work_Echart\EChartSimple\html\监控版\能源管理\执行进度.html, HTML, 0, 0, 0, 0, 29, 1, 4, 34
c:\Users\AORUS\Desktop\Work_Echart\EChartSimple\html\监控版\能源管理\拒绝邀约企业.html, HTML, 0, 0, 0, 0, 26, 0, 4, 30
c:\Users\AORUS\Desktop\Work_Echart\EChartSimple\html\监控版\能源管理\时间轴.html, HTML, 0, 0, 0, 0, 64, 1, 11, 76
c:\Users\AORUS\Desktop\Work_Echart\EChartSimple\html\监控版\能源管理\最新削峰填谷事件.html, HTML, 0, 0, 0, 0, 25, 0, 4, 29
c:\Users\AORUS\Desktop\Work_Echart\EChartSimple\html\监控版\能源管理\线路实时态势.html, HTML, 0, 0, 0, 0, 27, 1, 4, 32
c:\Users\AORUS\Desktop\Work_Echart\EChartSimple\html\监控版\能源管理\虚拟电厂出力曲线.html, HTML, 0, 0, 0, 0, 29, 1, 4, 34
c:\Users\AORUS\Desktop\Work_Echart\EChartSimple\html\监控版\能源管理\负载曲线.html, HTML, 0, 0, 0, 0, 27, 1, 4, 32
c:\Users\AORUS\Desktop\Work_Echart\EChartSimple\html\监控版\能源管理\邀约倒计时.html, HTML, 0, 0, 0, 0, 38, 0, 4, 42
c:\Users\AORUS\Desktop\Work_Echart\EChartSimple\html\监控版\能源管理\邀约进度.html, HTML, 0, 0, 0, 0, 29, 1, 4, 34
c:\Users\AORUS\Desktop\Work_Echart\EChartSimple\html\监控版\能源管理\高负载线路.html, HTML, 0, 0, 0, 0, 25, 0, 4, 29
c:\Users\AORUS\Desktop\Work_Echart\EChartSimple\html\监控版\驾驶舱.html, HTML, 0, 0, 0, 0, 39, 1, 4, 44
c:\Users\AORUS\Desktop\Work_Echart\EChartSimple\html\监控版\驾驶舱\全区用能概况.html, HTML, 0, 0, 0, 0, 27, 1, 4, 32
c:\Users\AORUS\Desktop\Work_Echart\EChartSimple\html\监控版\驾驶舱\削峰填谷事件概览.html, HTML, 0, 0, 0, 0, 27, 1, 4, 32
c:\Users\AORUS\Desktop\Work_Echart\EChartSimple\html\监控版\驾驶舱\合同数量增长趋势.html, HTML, 0, 0, 0, 0, 26, 1, 3, 30
c:\Users\AORUS\Desktop\Work_Echart\EChartSimple\html\监控版\驾驶舱\最新削峰填谷事件.html, HTML, 0, 0, 0, 0, 23, 0, 4, 27
c:\Users\AORUS\Desktop\Work_Echart\EChartSimple\html\监控版\驾驶舱\最新异常事件.html, HTML, 0, 0, 0, 0, 23, 0, 4, 27
c:\Users\AORUS\Desktop\Work_Echart\EChartSimple\html\监控版\驾驶舱\服务概况-个性化定制服务.html, HTML, 0, 0, 0, 0, 26, 0, 4, 30
c:\Users\AORUS\Desktop\Work_Echart\EChartSimple\html\监控版\驾驶舱\服务概况-分析报告订单服务.html, HTML, 0, 0, 0, 0, 26, 0, 4, 30
c:\Users\AORUS\Desktop\Work_Echart\EChartSimple\html\监控版\驾驶舱\服务概况-数据接入服务.html, HTML, 0, 0, 0, 0, 26, 0, 4, 30
c:\Users\AORUS\Desktop\Work_Echart\EChartSimple\html\监控版\驾驶舱\本月异常用能事件.html, HTML, 0, 0, 0, 0, 23, 0, 4, 27
c:\Users\AORUS\Desktop\Work_Echart\EChartSimple\html\监控版\驾驶舱\标签云.html, HTML, 0, 0, 0, 0, 28, 1, 3, 32
c:\Users\AORUS\Desktop\Work_Echart\EChartSimple\html\监控版\驾驶舱\标签云_New.html, HTML, 0, 0, 0, 0, 32, 2, 4, 38
c:\Users\AORUS\Desktop\Work_Echart\EChartSimple\html\监控版\驾驶舱\标签全生命周期.html, HTML, 0, 0, 0, 0, 26, 0, 6, 32
c:\Users\AORUS\Desktop\Work_Echart\EChartSimple\html\监控版\驾驶舱\标签概况.html, HTML, 0, 0, 0, 0, 29, 1, 4, 34
c:\Users\AORUS\Desktop\Work_Echart\EChartSimple\html\监控版\驾驶舱\能源交易概况.html, HTML, 0, 0, 0, 0, 26, 1, 4, 31
c:\Users\AORUS\Desktop\Work_Echart\EChartSimple\html\监控版\驾驶舱\能源应用.html, HTML, 0, 0, 0, 0, 23, 95, 4, 122
c:\Users\AORUS\Desktop\Work_Echart\EChartSimple\html\监控版\驾驶舱\行业消费排名.html, HTML, 0, 0, 0, 0, 26, 1, 4, 31
c:\Users\AORUS\Desktop\Work_Echart\EChartSimple\html\监控版\驾驶舱\近30天供需对比.html, HTML, 0, 0, 0, 0, 26, 1, 3, 30
c:\Users\AORUS\Desktop\Work_Echart\EChartSimple\html\监控版\驾驶舱\近一年异常原因分析.html, HTML, 0, 0, 0, 0, 26, 1, 4, 31
c:\Users\AORUS\Desktop\Work_Echart\EChartSimple\html\监控版\驾驶舱\近一年异常原因分析b.html, HTML, 0, 0, 0, 0, 26, 1, 3, 30
c:\Users\AORUS\Desktop\Work_Echart\EChartSimple\html\监控版\驾驶舱\重点监控企业-能耗.html, HTML, 0, 0, 0, 0, 26, 1, 3, 30
c:\Users\AORUS\Desktop\Work_Echart\EChartSimple\html\监控版\驾驶舱\高负载线路.html, HTML, 0, 0, 0, 0, 23, 0, 4, 27
c:\Users\AORUS\Desktop\Work_Echart\EChartSimple\html\矩形树图.html, HTML, 0, 0, 0, 0, 23, 0, 4, 27
c:\Users\AORUS\Desktop\Work_Echart\EChartSimple\html\能源交易.html, HTML, 0, 0, 0, 0, 27, 1, 5, 33
c:\Users\AORUS\Desktop\Work_Echart\EChartSimple\html\能源企业视角.html, HTML, 0, 0, 0, 0, 31, 1, 5, 37
c:\Users\AORUS\Desktop\Work_Echart\EChartSimple\html\能源应用.html, HTML, 0, 0, 0, 0, 22, 1, 5, 28
c:\Users\AORUS\Desktop\Work_Echart\EChartSimple\html\能源服务市场.html, HTML, 0, 0, 0, 0, 34, 0, 7, 41
c:\Users\AORUS\Desktop\Work_Echart\EChartSimple\html\能源管理.html, HTML, 0, 0, 0, 0, 29, 1, 6, 36
c:\Users\AORUS\Desktop\Work_Echart\EChartSimple\html\阴影文本.html, HTML, 0, 0, 0, 0, 16, 0, 4, 20
c:\Users\AORUS\Desktop\Work_Echart\EChartSimple\js\.vs\ProjectSettings.json, JSON, 0, 3, 0, 0, 0, 0, 0, 3
c:\Users\AORUS\Desktop\Work_Echart\EChartSimple\js\.vs\VSWorkspaceState.json, JSON, 0, 8, 0, 0, 0, 0, 0, 8
c:\Users\AORUS\Desktop\Work_Echart\EChartSimple\js\ColorCard.js, JavaScript, 0, 0, 0, 52, 0, 0, 4, 56
c:\Users\AORUS\Desktop\Work_Echart\EChartSimple\js\Horizontal_histogram.js, JavaScript, 0, 0, 0, 494, 0, 29, 1, 524
c:\Users\AORUS\Desktop\Work_Echart\EChartSimple\js\ShowRealData.js, JavaScript, 0, 0, 0, 308, 0, 0, 2, 310
c:\Users\AORUS\Desktop\Work_Echart\EChartSimple\js\Table.js, JavaScript, 0, 0, 0, 204, 0, 5, 0, 209
c:\Users\AORUS\Desktop\Work_Echart\EChartSimple\js\Tool\地区三级联动.js, JavaScript, 0, 0, 0, 227, 0, 73, 5, 305
c:\Users\AORUS\Desktop\Work_Echart\EChartSimple\js\Tool\地区三级联动展示版.js, JavaScript, 0, 0, 0, 227, 0, 73, 5, 305
c:\Users\AORUS\Desktop\Work_Echart\EChartSimple\js\Tool\导航小地图.js, JavaScript, 0, 0, 0, 116, 0, 4, 1, 121
c:\Users\AORUS\Desktop\Work_Echart\EChartSimple\js\Vertical_histogram.js, JavaScript, 0, 0, 0, 510, 0, 27, 4, 541
c:\Users\AORUS\Desktop\Work_Echart\EChartSimple\js\base.js, JavaScript, 0, 0, 0, 15301, 0, 0, 5, 15306
c:\Users\AORUS\Desktop\Work_Echart\EChartSimple\js\echarts.js, JavaScript, 0, 0, 0, 239, 0, 34, 0, 273
c:\Users\AORUS\Desktop\Work_Echart\EChartSimple\js\hotMap.js, JavaScript, 0, 0, 0, 2, 0, 0, 1, 3
c:\Users\AORUS\Desktop\Work_Echart\EChartSimple\js\line_chart.js, JavaScript, 0, 0, 0, 524, 0, 27, 2, 553
c:\Users\AORUS\Desktop\Work_Echart\EChartSimple\js\main.js, JavaScript, 0, 0, 0, 5, 0, 2, 2, 9
c:\Users\AORUS\Desktop\Work_Echart\EChartSimple\js\展示版\政府视角\ColorCard.js, JavaScript, 0, 0, 0, 62, 0, 0, 4, 66
c:\Users\AORUS\Desktop\Work_Echart\EChartSimple\js\展示版\政府视角\ColorCard.json, JSON, 0, 48, 0, 0, 0, 0, 2, 50
c:\Users\AORUS\Desktop\Work_Echart\EChartSimple\js\展示版\政府视角\base.js, JavaScript, 0, 0, 0, 37, 0, 0, 2, 39
c:\Users\AORUS\Desktop\Work_Echart\EChartSimple\js\展示版\政府视角\万元产值能耗.js, JavaScript, 0, 0, 0, 406, 0, 22, 17, 445
c:\Users\AORUS\Desktop\Work_Echart\EChartSimple\js\展示版\政府视角\企业异常用能事件.js, JavaScript, 0, 0, 0, 239, 0, 7, 7, 253
c:\Users\AORUS\Desktop\Work_Echart\EChartSimple\js\展示版\政府视角\企业概况.js, JavaScript, 0, 0, 0, 80, 0, 7, 15, 102
c:\Users\AORUS\Desktop\Work_Echart\EChartSimple\js\展示版\政府视角\企业能源消费排行.js, JavaScript, 0, 0, 0, 377, 0, 19, 21, 417
c:\Users\AORUS\Desktop\Work_Echart\EChartSimple\js\展示版\政府视角\区域概况.js, JavaScript, 0, 0, 0, 199, 0, 7, 25, 231
c:\Users\AORUS\Desktop\Work_Echart\EChartSimple\js\展示版\政府视角\区域能源消费比例.js, JavaScript, 0, 0, 0, 270, 0, 17, 19, 306
c:\Users\AORUS\Desktop\Work_Echart\EChartSimple\js\展示版\政府视角\区域能源消费结构.js, JavaScript, 0, 0, 0, 252, 0, 10, 18, 280
c:\Users\AORUS\Desktop\Work_Echart\EChartSimple\js\展示版\政府视角\单位面积能耗.js, JavaScript, 0, 0, 0, 408, 0, 13, 17, 438
c:\Users\AORUS\Desktop\Work_Echart\EChartSimple\js\展示版\政府视角\年度供需对比 copy.js, JavaScript, 0, 0, 0, 972, 0, 50, 15, 1037
c:\Users\AORUS\Desktop\Work_Echart\EChartSimple\js\展示版\政府视角\年度供需对比.js, JavaScript, 0, 0, 0, 1040, 0, 29, 32, 1101
c:\Users\AORUS\Desktop\Work_Echart\EChartSimple\js\展示版\政府视角\年度综合能耗环比.js, JavaScript, 0, 0, 0, 435, 0, 15, 16, 466
c:\Users\AORUS\Desktop\Work_Echart\EChartSimple\js\展示版\政府视角\度电经济增加值.js, JavaScript, 0, 0, 0, 406, 0, 23, 15, 444
c:\Users\AORUS\Desktop\Work_Echart\EChartSimple\js\展示版\政府视角\异常用能原因.js, JavaScript, 0, 0, 0, 613, 0, 30, 23, 666
c:\Users\AORUS\Desktop\Work_Echart\EChartSimple\js\展示版\政府视角\异常能源监测.js, JavaScript, 0, 0, 0, 198, 0, 7, 25, 230
c:\Users\AORUS\Desktop\Work_Echart\EChartSimple\js\展示版\政府视角\最新异常事件.js, JavaScript, 0, 0, 0, 211, 0, 7, 8, 226
c:\Users\AORUS\Desktop\Work_Echart\EChartSimple\js\展示版\政府视角\有功图表x.js, JavaScript, 0, 0, 0, 515, 0, 30, 23, 568
c:\Users\AORUS\Desktop\Work_Echart\EChartSimple\js\展示版\政府视角\标签云.js, JavaScript, 0, 0, 0, 84, 0, 3, 9, 96
c:\Users\AORUS\Desktop\Work_Echart\EChartSimple\js\展示版\政府视角\标签云1.js, JavaScript, 0, 0, 0, 153, 0, 6, 17, 176
c:\Users\AORUS\Desktop\Work_Echart\EChartSimple\js\展示版\政府视角\清洁能源占比.js, JavaScript, 0, 0, 0, 426, 0, 13, 26, 465
c:\Users\AORUS\Desktop\Work_Echart\EChartSimple\js\展示版\政府视角\特征图表一.js, JavaScript, 0, 0, 0, 513, 0, 30, 23, 566
c:\Users\AORUS\Desktop\Work_Echart\EChartSimple\js\展示版\政府视角\特征图表三.js, JavaScript, 0, 0, 0, 518, 0, 30, 24, 572
c:\Users\AORUS\Desktop\Work_Echart\EChartSimple\js\展示版\政府视角\特征图表二.js, JavaScript, 0, 0, 0, 511, 0, 24, 23, 558
c:\Users\AORUS\Desktop\Work_Echart\EChartSimple\js\展示版\政府视角\碳排放.js, JavaScript, 0, 0, 0, 424, 0, 22, 17, 463
c:\Users\AORUS\Desktop\Work_Echart\EChartSimple\js\展示版\政府视角\综合能耗.js, JavaScript, 0, 0, 0, 406, 0, 22, 14, 442
c:\Users\AORUS\Desktop\Work_Echart\EChartSimple\js\展示版\政府视角\能效环比.js, JavaScript, 0, 0, 0, 622, 0, 19, 12, 653
c:\Users\AORUS\Desktop\Work_Echart\EChartSimple\js\展示版\政府视角\能级评价指标.js, JavaScript, 0, 0, 0, 215, 0, 8, 17, 240
c:\Users\AORUS\Desktop\Work_Echart\EChartSimple\js\展示版\政府视角\自我学习趋势图.js, JavaScript, 0, 0, 0, 502, 0, 30, 23, 555
c:\Users\AORUS\Desktop\Work_Echart\EChartSimple\js\展示版\政府视角\行业能源消费排行.js, JavaScript, 0, 0, 0, 365, 0, 19, 15, 399
c:\Users\AORUS\Desktop\Work_Echart\EChartSimple\js\展示版\能源企业视角\ColorCard.js, JavaScript, 0, 0, 0, 39, 0, 0, 2, 41
c:\Users\AORUS\Desktop\Work_Echart\EChartSimple\js\展示版\能源企业视角\ColorCard.json, JSON, 0, 24, 0, 0, 0, 0, 2, 26
c:\Users\AORUS\Desktop\Work_Echart\EChartSimple\js\展示版\能源企业视角\事件概况.js, JavaScript, 0, 0, 0, 91, 0, 1, 11, 103
c:\Users\AORUS\Desktop\Work_Echart\EChartSimple\js\展示版\能源企业视角\削峰填谷事件回顾.js, JavaScript, 0, 0, 0, 373, 0, 7, 11, 391
c:\Users\AORUS\Desktop\Work_Echart\EChartSimple\js\展示版\能源企业视角\区域概况.js, JavaScript, 0, 0, 0, 508, 0, 27, 56, 591
c:\Users\AORUS\Desktop\Work_Echart\EChartSimple\js\展示版\能源企业视角\客户区域分析.js, JavaScript, 0, 0, 0, 381, 0, 25, 33, 439
c:\Users\AORUS\Desktop\Work_Echart\EChartSimple\js\展示版\能源企业视角\客户行业分析.js, JavaScript, 0, 0, 0, 459, 0, 38, 43, 540
c:\Users\AORUS\Desktop\Work_Echart\EChartSimple\js\展示版\能源企业视角\总响应量排行榜.js, JavaScript, 0, 0, 0, 97, 0, 1, 10, 108
c:\Users\AORUS\Desktop\Work_Echart\EChartSimple\js\展示版\能源企业视角\标签云.js, JavaScript, 0, 0, 0, 80, 0, 3, 10, 93
c:\Users\AORUS\Desktop\Work_Echart\EChartSimple\js\展示版\能源企业视角\标签云1.js, JavaScript, 0, 0, 0, 143, 0, 6, 17, 166
c:\Users\AORUS\Desktop\Work_Echart\EChartSimple\js\展示版\能源企业视角\线路负载率.js, JavaScript, 0, 0, 0, 310, 0, 12, 10, 332
c:\Users\AORUS\Desktop\Work_Echart\EChartSimple\js\展示版\能源企业视角\线路负载率对比.js, JavaScript, 0, 0, 0, 540, 0, 21, 39, 600
c:\Users\AORUS\Desktop\Work_Echart\EChartSimple\js\展示版\能源企业视角\虚拟电厂出力曲线.js, JavaScript, 0, 0, 0, 459, 0, 19, 33, 511
c:\Users\AORUS\Desktop\Work_Echart\EChartSimple\js\展示版\能源企业视角\虚拟电厂完结汇总.js, JavaScript, 0, 0, 0, 425, 0, 15, 66, 506
c:\Users\AORUS\Desktop\Work_Echart\EChartSimple\js\展示版\能源企业视角\近一年削峰填谷事件数量.js, JavaScript, 0, 0, 0, 477, 0, 18, 29, 524
c:\Users\AORUS\Desktop\Work_Echart\EChartSimple\js\展示版\能源企业视角\高-低负载线路.js, JavaScript, 0, 0, 0, 409, 0, 10, 16, 435
c:\Users\AORUS\Desktop\Work_Echart\EChartSimple\js\展示版\能源客户视角\ColorCard.js, JavaScript, 0, 0, 0, 88, 0, 0, 3, 91
c:\Users\AORUS\Desktop\Work_Echart\EChartSimple\js\展示版\能源客户视角\ColorCard.json, JSON, 0, 73, 0, 0, 0, 0, 3, 76
c:\Users\AORUS\Desktop\Work_Echart\EChartSimple\js\展示版\能源客户视角\base.js, JavaScript, 0, 0, 0, 31, 0, 0, 4, 35
c:\Users\AORUS\Desktop\Work_Echart\EChartSimple\js\展示版\能源客户视角\企业能效top20.js, JavaScript, 0, 0, 0, 948, 0, 7, 48, 1003
c:\Users\AORUS\Desktop\Work_Echart\EChartSimple\js\展示版\能源客户视角\企业能耗top20.js, JavaScript, 0, 0, 0, 551, 0, 13, 34, 598
c:\Users\AORUS\Desktop\Work_Echart\EChartSimple\js\展示版\能源客户视角\出线柜.js, JavaScript, 0, 0, 0, 172, 0, 6, 7, 185
c:\Users\AORUS\Desktop\Work_Echart\EChartSimple\js\展示版\能源客户视角\功率因数行业排名.js, JavaScript, 0, 0, 0, 499, 0, 27, 37, 563
c:\Users\AORUS\Desktop\Work_Echart\EChartSimple\js\展示版\能源客户视角\功率因数详情.js, JavaScript, 0, 0, 0, 125, 0, 7, 9, 141
c:\Users\AORUS\Desktop\Work_Echart\EChartSimple\js\展示版\能源客户视角\区域概况.js, JavaScript, 0, 0, 0, 199, 0, 6, 30, 235
c:\Users\AORUS\Desktop\Work_Echart\EChartSimple\js\展示版\能源客户视角\去年电量构成-楼宇.js, JavaScript, 0, 0, 0, 268, 0, 12, 25, 305
c:\Users\AORUS\Desktop\Work_Echart\EChartSimple\js\展示版\能源客户视角\去年电量构成-电量峰谷.js, JavaScript, 0, 0, 0, 280, 0, 13, 25, 318
c:\Users\AORUS\Desktop\Work_Echart\EChartSimple\js\展示版\能源客户视角\变压器.js, JavaScript, 0, 0, 0, 181, 0, 15, 7, 203
c:\Users\AORUS\Desktop\Work_Echart\EChartSimple\js\展示版\能源客户视角\各月功率因数及力率奖惩电费.js, JavaScript, 0, 0, 0, 757, 0, 39, 109, 905
c:\Users\AORUS\Desktop\Work_Echart\EChartSimple\js\展示版\能源客户视角\各楼层功能.js, JavaScript, 0, 0, 0, 253, 0, 8, 9, 270
c:\Users\AORUS\Desktop\Work_Echart\EChartSimple\js\展示版\能源客户视角\各楼层能效.js, JavaScript, 0, 0, 0, 525, 0, 39, 66, 630
c:\Users\AORUS\Desktop\Work_Echart\EChartSimple\js\展示版\能源客户视角\各楼层能耗.js, JavaScript, 0, 0, 0, 534, 0, 36, 67, 637
c:\Users\AORUS\Desktop\Work_Echart\EChartSimple\js\展示版\能源客户视角\园区年度综合能耗环比.js, JavaScript, 0, 0, 0, 466, 0, 14, 29, 509
c:\Users\AORUS\Desktop\Work_Echart\EChartSimple\js\展示版\能源客户视角\园区楼宇能效_单位建筑面积能耗.js, JavaScript, 0, 0, 0, 541, 0, 54, 31, 626
c:\Users\AORUS\Desktop\Work_Echart\EChartSimple\js\展示版\能源客户视角\园区楼宇能耗排名.js, JavaScript, 0, 0, 0, 566, 0, 54, 26, 646
c:\Users\AORUS\Desktop\Work_Echart\EChartSimple\js\展示版\能源客户视角\园区能效top20.js, JavaScript, 0, 0, 0, 950, 0, 21, 40, 1011
c:\Users\AORUS\Desktop\Work_Echart\EChartSimple\js\展示版\能源客户视角\园区能效环比.js, JavaScript, 0, 0, 0, 649, 0, 12, 29, 690
c:\Users\AORUS\Desktop\Work_Echart\EChartSimple\js\展示版\能源客户视角\园区能级评价指标.js, JavaScript, 0, 0, 0, 219, 0, 7, 23, 249
c:\Users\AORUS\Desktop\Work_Echart\EChartSimple\js\展示版\能源客户视角\园区能耗top20.js, JavaScript, 0, 0, 0, 546, 0, 18, 36, 600
c:\Users\AORUS\Desktop\Work_Echart\EChartSimple\js\展示版\能源客户视角\套管温度变化.js, JavaScript, 0, 0, 0, 776, 0, 33, 38, 847
c:\Users\AORUS\Desktop\Work_Echart\EChartSimple\js\展示版\能源客户视角\峰谷平电量占比与峰谷比.js, JavaScript, 0, 0, 0, 719, 0, 10, 97, 826
c:\Users\AORUS\Desktop\Work_Echart\EChartSimple\js\展示版\能源客户视角\年供需对比曲线.js, JavaScript, 0, 0, 0, 1049, 0, 21, 32, 1102
c:\Users\AORUS\Desktop\Work_Echart\EChartSimple\js\展示版\能源客户视角\年度综合能耗环比.js, JavaScript, 0, 0, 0, 469, 0, 14, 30, 513
c:\Users\AORUS\Desktop\Work_Echart\EChartSimple\js\展示版\能源客户视角\张江人工智能岛.js, JavaScript, 0, 0, 0, 130, 0, 7, 12, 149
c:\Users\AORUS\Desktop\Work_Echart\EChartSimple\js\展示版\能源客户视角\最大设备利用率.js, JavaScript, 0, 0, 0, 668, 0, 8, 96, 772
c:\Users\AORUS\Desktop\Work_Echart\EChartSimple\js\展示版\能源客户视角\最大设备利用率行业排名.js, JavaScript, 0, 0, 0, 489, 0, 27, 36, 552
c:\Users\AORUS\Desktop\Work_Echart\EChartSimple\js\展示版\能源客户视角\楼宇概况.js, JavaScript, 0, 0, 0, 137, 0, 7, 13, 157
c:\Users\AORUS\Desktop\Work_Echart\EChartSimple\js\展示版\能源客户视角\温度监测-红外图谱.js, JavaScript, 0, 0, 0, 478, 0, 83, 39, 600
c:\Users\AORUS\Desktop\Work_Echart\EChartSimple\js\展示版\能源客户视角\用电经济性指标同行对比.js, JavaScript, 0, 0, 0, 434, 0, 16, 28, 478
c:\Users\AORUS\Desktop\Work_Echart\EChartSimple\js\展示版\能源客户视角\电量峰谷比行业排名.js, JavaScript, 0, 0, 0, 500, 0, 34, 45, 579
c:\Users\AORUS\Desktop\Work_Echart\EChartSimple\js\展示版\能源客户视角\电量峰谷比详情.js, JavaScript, 0, 0, 0, 125, 0, 7, 11, 143
c:\Users\AORUS\Desktop\Work_Echart\EChartSimple\js\展示版\能源客户视角\能效环比.js, JavaScript, 0, 0, 0, 656, 0, 11, 34, 701
c:\Users\AORUS\Desktop\Work_Echart\EChartSimple\js\展示版\能源客户视角\能级评价指标.js, JavaScript, 0, 0, 0, 236, 0, 7, 16, 259
c:\Users\AORUS\Desktop\Work_Echart\EChartSimple\js\展示版\能源客户视角\计量柜.js, JavaScript, 0, 0, 0, 172, 0, 6, 9, 187
c:\Users\AORUS\Desktop\Work_Echart\EChartSimple\js\展示版\能源客户视角\设备利用率详情.js, JavaScript, 0, 0, 0, 125, 0, 7, 13, 145
c:\Users\AORUS\Desktop\Work_Echart\EChartSimple\js\展示版\能源客户视角\设备运行状况分析.js, JavaScript, 0, 0, 0, 138, 0, 7, 10, 155
c:\Users\AORUS\Desktop\Work_Echart\EChartSimple\js\展示版\能源客户视角\进线柜.js, JavaScript, 0, 0, 0, 172, 0, 6, 9, 187
c:\Users\AORUS\Desktop\Work_Echart\EChartSimple\js\展示版\能源服务市场\ColorCard.js, JavaScript, 0, 0, 0, 44, 0, 0, 5, 49
c:\Users\AORUS\Desktop\Work_Echart\EChartSimple\js\展示版\能源服务市场\ColorCard.json, JSON, 0, 27, 0, 0, 0, 0, 3, 30
c:\Users\AORUS\Desktop\Work_Echart\EChartSimple\js\展示版\能源服务市场\base.js, JavaScript, 0, 0, 0, 59, 0, 0, 3, 62
c:\Users\AORUS\Desktop\Work_Echart\EChartSimple\js\展示版\能源服务市场\产业联盟星级评定.js, JavaScript, 0, 0, 0, 436, 0, 32, 37, 505
c:\Users\AORUS\Desktop\Work_Echart\EChartSimple\js\展示版\能源服务市场\亿可能源服务公司.js, JavaScript, 0, 0, 0, 341, 0, 24, 31, 396
c:\Users\AORUS\Desktop\Work_Echart\EChartSimple\js\展示版\能源服务市场\企业标签云.js, JavaScript, 0, 0, 0, 80, 0, 3, 11, 94
c:\Users\AORUS\Desktop\Work_Echart\EChartSimple\js\展示版\能源服务市场\企业标签云1.js, JavaScript, 0, 0, 0, 79, 0, 3, 10, 92
c:\Users\AORUS\Desktop\Work_Echart\EChartSimple\js\展示版\能源服务市场\企业概况.js, JavaScript, 0, 0, 0, 80, 0, 6, 15, 101
c:\Users\AORUS\Desktop\Work_Echart\EChartSimple\js\展示版\能源服务市场\企业能耗.js, JavaScript, 0, 0, 0, 417, 0, 21, 24, 462
c:\Users\AORUS\Desktop\Work_Echart\EChartSimple\js\展示版\能源服务市场\区域概况.js, JavaScript, 0, 0, 0, 199, 0, 7, 27, 233
c:\Users\AORUS\Desktop\Work_Echart\EChartSimple\js\展示版\能源服务市场\历史评价.js, JavaScript, 0, 0, 0, 130, 0, 3, 12, 145
c:\Users\AORUS\Desktop\Work_Echart\EChartSimple\js\展示版\能源服务市场\各类商品成交趋势.js, JavaScript, 0, 0, 0, 534, 0, 10, 34, 578
c:\Users\AORUS\Desktop\Work_Echart\EChartSimple\js\展示版\能源服务市场\合同数量变化趋势.js, JavaScript, 0, 0, 0, 469, 0, 15, 23, 507
c:\Users\AORUS\Desktop\Work_Echart\EChartSimple\js\展示版\能源服务市场\客户区域分析.js, JavaScript, 0, 0, 0, 429, 0, 17, 34, 480
c:\Users\AORUS\Desktop\Work_Echart\EChartSimple\js\展示版\能源服务市场\客户行业分析.js, JavaScript, 0, 0, 0, 468, 0, 23, 51, 542
c:\Users\AORUS\Desktop\Work_Echart\EChartSimple\js\展示版\能源服务市场\客户行业分析_Old.js, JavaScript, 0, 0, 0, 358, 0, 36, 35, 429
c:\Users\AORUS\Desktop\Work_Echart\EChartSimple\js\展示版\能源服务市场\明星商品销量.js, JavaScript, 0, 0, 0, 409, 0, 17, 31, 457
c:\Users\AORUS\Desktop\Work_Echart\EChartSimple\js\展示版\能源服务市场\累计需求流失.js, JavaScript, 0, 0, 0, 462, 0, 23, 39, 524
c:\Users\AORUS\Desktop\Work_Echart\EChartSimple\js\展示版\能源服务市场\经营服务范围.js, JavaScript, 0, 0, 0, 119, 0, 3, 12, 134
c:\Users\AORUS\Desktop\Work_Echart\EChartSimple\js\展示版\能源服务市场\能效环比.js, JavaScript, 0, 0, 0, 652, 0, 24, 23, 699
c:\Users\AORUS\Desktop\Work_Echart\EChartSimple\js\展示版\能源服务市场\能源服务市场概括.js, JavaScript, 0, 0, 0, 173, 0, 7, 22, 202
c:\Users\AORUS\Desktop\Work_Echart\EChartSimple\js\展示版\能源服务市场\需求-商品成交分类占比.js, JavaScript, 0, 0, 0, 413, 0, 15, 48, 476
c:\Users\AORUS\Desktop\Work_Echart\EChartSimple\js\展示版\能源服务市场\需求-商品成交转换率.js, JavaScript, 0, 0, 0, 188, 0, 6, 11, 205
c:\Users\AORUS\Desktop\Work_Echart\EChartSimple\js\控制版\main.js, JavaScript, 0, 0, 0, 82, 0, 0, 5, 87
c:\Users\AORUS\Desktop\Work_Echart\EChartSimple\js\控制版\交易总览.js, JavaScript, 0, 0, 0, 0, 0, 0, 1, 1
c:\Users\AORUS\Desktop\Work_Echart\EChartSimple\js\控制版\交易详情.js, JavaScript, 0, 0, 0, 60, 0, 10, 18, 88
c:\Users\AORUS\Desktop\Work_Echart\EChartSimple\js\控制版\区域分析.js, JavaScript, 0, 0, 0, 0, 0, 0, 1, 1
c:\Users\AORUS\Desktop\Work_Echart\EChartSimple\js\控制版\大屏首页.js, JavaScript, 0, 0, 0, 0, 0, 0, 1, 1
c:\Users\AORUS\Desktop\Work_Echart\EChartSimple\js\控制版\客户特征分析.js, JavaScript, 0, 0, 0, 34, 0, 5, 10, 49
c:\Users\AORUS\Desktop\Work_Echart\EChartSimple\js\控制版\异常用能分析.js, JavaScript, 0, 0, 0, 34, 0, 7, 5, 46
c:\Users\AORUS\Desktop\Work_Echart\EChartSimple\js\控制版\服务概况.js, JavaScript, 0, 0, 0, 0, 0, 0, 1, 1
c:\Users\AORUS\Desktop\Work_Echart\EChartSimple\js\控制版\服务详情.js, JavaScript, 0, 0, 0, 21, 0, 3, 4, 28
c:\Users\AORUS\Desktop\Work_Echart\EChartSimple\js\控制版\能源应用.js, JavaScript, 0, 0, 0, 21, 0, 4, 4, 29
c:\Users\AORUS\Desktop\Work_Echart\EChartSimple\js\控制版\能源监控.js, JavaScript, 0, 0, 0, 0, 0, 0, 1, 1
c:\Users\AORUS\Desktop\Work_Echart\EChartSimple\js\控制版\能源管理.js, JavaScript, 0, 0, 0, 52, 0, 8, 10, 70
c:\Users\AORUS\Desktop\Work_Echart\EChartSimple\js\监控版\能源交易\交易总览\各类商品成交趋势.js, JavaScript, 0, 0, 0, 579, 0, 17, 28, 624
c:\Users\AORUS\Desktop\Work_Echart\EChartSimple\js\监控版\能源交易\交易总览\商品成交分类占比.js, JavaScript, 0, 0, 0, 284, 0, 22, 33, 339
c:\Users\AORUS\Desktop\Work_Echart\EChartSimple\js\监控版\能源交易\交易总览\商品成交转换率.js, JavaScript, 0, 0, 0, 124, 0, 3, 11, 138
c:\Users\AORUS\Desktop\Work_Echart\EChartSimple\js\监控版\能源交易\交易总览\客户区域分析.js, JavaScript, 0, 0, 0, 438, 0, 39, 38, 515
c:\Users\AORUS\Desktop\Work_Echart\EChartSimple\js\监控版\能源交易\交易总览\客户行业分布占比.js, JavaScript, 0, 0, 0, 455, 0, 24, 54, 533
c:\Users\AORUS\Desktop\Work_Echart\EChartSimple\js\监控版\能源交易\交易总览\搁置需求列表.js, JavaScript, 0, 0, 0, 305, 0, 10, 13, 328
c:\Users\AORUS\Desktop\Work_Echart\EChartSimple\js\监控版\能源交易\交易总览\明星商品销量.js, JavaScript, 0, 0, 0, 370, 0, 23, 31, 424
c:\Users\AORUS\Desktop\Work_Echart\EChartSimple\js\监控版\能源交易\交易总览\累计需求流失分类占比.js, JavaScript, 0, 0, 0, 440, 0, 50, 36, 526
c:\Users\AORUS\Desktop\Work_Echart\EChartSimple\js\监控版\能源交易\交易总览\能源交易左侧图元.js, JavaScript, 0, 0, 0, 253, 0, 24, 35, 312
c:\Users\AORUS\Desktop\Work_Echart\EChartSimple\js\监控版\能源交易\交易总览\能源服务商列表.js, JavaScript, 0, 0, 0, 139, 0, 18, 14, 171
c:\Users\AORUS\Desktop\Work_Echart\EChartSimple\js\监控版\能源交易\交易总览\评分占比.js, JavaScript, 0, 0, 0, 246, 0, 12, 20, 278
c:\Users\AORUS\Desktop\Work_Echart\EChartSimple\js\监控版\能源交易\交易总览\需求成交分类占比.js, JavaScript, 0, 0, 0, 272, 0, 35, 36, 343
c:\Users\AORUS\Desktop\Work_Echart\EChartSimple\js\监控版\能源交易\交易总览\需求成交转换率.js, JavaScript, 0, 0, 0, 124, 0, 3, 12, 139
c:\Users\AORUS\Desktop\Work_Echart\EChartSimple\js\监控版\能源交易\交易详情\上海日月光半导体公司.js, JavaScript, 0, 0, 0, 102, 0, 5, 24, 131
c:\Users\AORUS\Desktop\Work_Echart\EChartSimple\js\监控版\能源交易\交易详情\企业简介.js, JavaScript, 0, 0, 0, 88, 0, 3, 17, 108
c:\Users\AORUS\Desktop\Work_Echart\EChartSimple\js\监控版\能源交易\交易详情\合同评价.js, JavaScript, 0, 0, 0, 82, 0, 1, 14, 97
c:\Users\AORUS\Desktop\Work_Echart\EChartSimple\js\监控版\能源交易\交易详情\商品交易概况.js, JavaScript, 0, 0, 0, 232, 0, 17, 34, 283
c:\Users\AORUS\Desktop\Work_Echart\EChartSimple\js\监控版\能源交易\交易详情\商品信息.js, JavaScript, 0, 0, 0, 103, 0, 5, 23, 131
c:\Users\AORUS\Desktop\Work_Echart\EChartSimple\js\监控版\能源交易\交易详情\商品订单数量曲线.js, JavaScript, 0, 0, 0, 526, 0, 19, 30, 575
c:\Users\AORUS\Desktop\Work_Echart\EChartSimple\js\监控版\能源交易\交易详情\商品详情列表.js, JavaScript, 0, 0, 0, 4311, 0, 12, 20, 4343
c:\Users\AORUS\Desktop\Work_Echart\EChartSimple\js\监控版\能源交易\交易详情\设备购买合同.js, JavaScript, 0, 0, 0, 131, 0, 10, 8, 149
c:\Users\AORUS\Desktop\Work_Echart\EChartSimple\js\监控版\能源交易\交易详情\需求方-上海通用重工.js, JavaScript, 0, 0, 0, 106, 0, 5, 11, 122
c:\Users\AORUS\Desktop\Work_Echart\EChartSimple\js\监控版\能源交易\交易详情\需求方.js, JavaScript, 0, 0, 0, 64, 0, 1, 12, 77
c:\Users\AORUS\Desktop\Work_Echart\EChartSimple\js\监控版\能源交易\交易详情\需求详情列表.js, JavaScript, 0, 0, 0, 3513, 0, 12, 16, 3541
c:\Users\AORUS\Desktop\Work_Echart\EChartSimple\js\监控版\能源分析\企业分析\企业能耗综合分析.js, JavaScript, 0, 0, 0, 394, 0, 11, 28, 433
c:\Users\AORUS\Desktop\Work_Echart\EChartSimple\js\监控版\能源分析\企业分析\功率因数趋势.js, JavaScript, 0, 0, 0, 1310, 0, 39, 48, 1397
c:\Users\AORUS\Desktop\Work_Echart\EChartSimple\js\监控版\能源分析\企业分析\区域用能对比.js, JavaScript, 0, 0, 0, 687, 0, 41, 43, 771
c:\Users\AORUS\Desktop\Work_Echart\EChartSimple\js\监控版\能源分析\企业分析\单位面积能耗趋势.js, JavaScript, 0, 0, 0, 1318, 0, 17, 50, 1385
c:\Users\AORUS\Desktop\Work_Echart\EChartSimple\js\监控版\能源分析\企业分析\度电经济产值趋势.js, JavaScript, 0, 0, 0, 1317, 0, 30, 49, 1396
c:\Users\AORUS\Desktop\Work_Echart\EChartSimple\js\监控版\能源分析\企业分析\月度区域用能分析.js, JavaScript, 0, 0, 0, 336, 0, 35, 29, 400
c:\Users\AORUS\Desktop\Work_Echart\EChartSimple\js\监控版\能源分析\企业分析\月度设备用能分析.js, JavaScript, 0, 0, 0, 348, 0, 40, 32, 420
c:\Users\AORUS\Desktop\Work_Echart\EChartSimple\js\监控版\能源分析\企业分析\碳排放趋势.js, JavaScript, 0, 0, 0, 1319, 0, 82, 54, 1455
c:\Users\AORUS\Desktop\Work_Echart\EChartSimple\js\监控版\能源分析\企业分析\综合能耗同比环比对比.js, JavaScript, 0, 0, 0, 1273, 0, 32, 34, 1339
c:\Users\AORUS\Desktop\Work_Echart\EChartSimple\js\监控版\能源分析\企业分析\设备用能对比.js, JavaScript, 0, 0, 0, 685, 0, 48, 44, 777
c:\Users\AORUS\Desktop\Work_Echart\EChartSimple\js\监控版\能源分析\区域分析\产业能源消费占比.js, JavaScript, 0, 0, 0, 259, 0, 18, 19, 296
c:\Users\AORUS\Desktop\Work_Echart\EChartSimple\js\监控版\能源分析\区域分析\区域概况.js, JavaScript, 0, 0, 0, 73, 0, 1, 11, 85
c:\Users\AORUS\Desktop\Work_Echart\EChartSimple\js\监控版\能源分析\区域分析\各区域碳排放.js, JavaScript, 0, 0, 0, 394, 0, 22, 39, 455
c:\Users\AORUS\Desktop\Work_Echart\EChartSimple\js\监控版\能源分析\区域分析\各区域综合能耗.js, JavaScript, 0, 0, 0, 395, 0, 15, 39, 449
c:\Users\AORUS\Desktop\Work_Echart\EChartSimple\js\监控版\能源分析\区域分析\各区能效.js, JavaScript, 0, 0, 0, 589, 0, 13, 52, 654
c:\Users\AORUS\Desktop\Work_Echart\EChartSimple\js\监控版\能源分析\区域分析\各行业万元产值能耗.js, JavaScript, 0, 0, 0, 511, 0, 9, 30, 550
c:\Users\AORUS\Desktop\Work_Echart\EChartSimple\js\监控版\能源分析\区域分析\各行业综合能耗.js, JavaScript, 0, 0, 0, 521, 0, 13, 39, 573
c:\Users\AORUS\Desktop\Work_Echart\EChartSimple\js\监控版\能源分析\区域分析\行业能源消费占比.js, JavaScript, 0, 0, 0, 311, 0, 12, 21, 344
c:\Users\AORUS\Desktop\Work_Echart\EChartSimple\js\监控版\能源分析\区域分析\行业能源消费占比_Old.js, JavaScript, 0, 0, 0, 457, 0, 22, 54, 533
c:\Users\AORUS\Desktop\Work_Echart\EChartSimple\js\监控版\能源分析\区域分析\近30天耗能趋势.js, JavaScript, 0, 0, 0, 1383, 0, 30, 44, 1457
c:\Users\AORUS\Desktop\Work_Echart\EChartSimple\js\监控版\能源分析\区域分析\重点企业监控能耗.js, JavaScript, 0, 0, 0, 526, 0, 23, 33, 582
c:\Users\AORUS\Desktop\Work_Echart\EChartSimple\js\监控版\能源分析\客户特征分析\企业标签演变趋势.js, JavaScript, 0, 0, 0, 480, 0, 32, 30, 542
c:\Users\AORUS\Desktop\Work_Echart\EChartSimple\js\监控版\能源分析\客户特征分析\企业概况.js, JavaScript, 0, 0, 0, 126, 0, 4, 8, 138
c:\Users\AORUS\Desktop\Work_Echart\EChartSimple\js\监控版\能源分析\客户特征分析\客户特征分析地图.js, JavaScript, 0, 0, 0, 291, 0, 17, 10, 318
c:\Users\AORUS\Desktop\Work_Echart\EChartSimple\js\监控版\能源分析\客户特征分析\标签企业列表.js, JavaScript, 0, 0, 0, 87, 0, 2, 6, 95
c:\Users\AORUS\Desktop\Work_Echart\EChartSimple\js\监控版\能源分析\客户特征分析\标签分类占比.js, JavaScript, 0, 0, 0, 622, 0, 8, 17, 647
c:\Users\AORUS\Desktop\Work_Echart\EChartSimple\js\监控版\能源分析\客户特征分析\标签概况.js, JavaScript, 0, 0, 0, 281, 0, 30, 30, 341
c:\Users\AORUS\Desktop\Work_Echart\EChartSimple\js\监控版\能源分析\客户特征分析\标签调用排行.js, JavaScript, 0, 0, 0, 98, 0, 0, 11, 109
c:\Users\AORUS\Desktop\Work_Echart\EChartSimple\js\监控版\能源分析\异常用能分析\人工复检结果.js, JavaScript, 0, 0, 0, 129, 0, 1, 12, 142
c:\Users\AORUS\Desktop\Work_Echart\EChartSimple\js\监控版\能源分析\异常用能分析\企业异常事件.js, JavaScript, 0, 0, 0, 289, 0, 6, 14, 309
c:\Users\AORUS\Desktop\Work_Echart\EChartSimple\js\监控版\能源分析\异常用能分析\企业标签.js, JavaScript, 0, 0, 0, 86, 0, 1, 10, 97
c:\Users\AORUS\Desktop\Work_Echart\EChartSimple\js\监控版\能源分析\异常用能分析\区域异常排名.js, JavaScript, 0, 0, 0, 381, 0, 27, 36, 444
c:\Users\AORUS\Desktop\Work_Echart\EChartSimple\js\监控版\能源分析\异常用能分析\年度异常原因变化分析.js, JavaScript, 0, 0, 0, 642, 0, 17, 28, 687
c:\Users\AORUS\Desktop\Work_Echart\EChartSimple\js\监控版\能源分析\异常用能分析\异常事件列表.js, JavaScript, 0, 0, 0, 849, 0, 7, 24, 880
c:\Users\AORUS\Desktop\Work_Echart\EChartSimple\js\监控版\能源分析\异常用能分析\异常事件详情.js, JavaScript, 0, 0, 0, 279, 0, 33, 43, 355
c:\Users\AORUS\Desktop\Work_Echart\EChartSimple\js\监控版\能源分析\异常用能分析\异常原因AI判断.js, JavaScript, 0, 0, 0, 260, 0, 16, 25, 301
c:\Users\AORUS\Desktop\Work_Echart\EChartSimple\js\监控版\能源分析\异常用能分析\本月异常.js, JavaScript, 0, 0, 0, 233, 0, 14, 36, 283
c:\Users\AORUS\Desktop\Work_Echart\EChartSimple\js\监控版\能源分析\异常用能分析\行业异常排名.js, JavaScript, 0, 0, 0, 492, 0, 39, 45, 576
c:\Users\AORUS\Desktop\Work_Echart\EChartSimple\js\监控版\能源分析\异常用能分析\预判准确率趋势.js, JavaScript, 0, 0, 0, 472, 0, 18, 30, 520
c:\Users\AORUS\Desktop\Work_Echart\EChartSimple\js\监控版\能源应用\专家入驻趋势.js, JavaScript, 0, 0, 0, 426, 0, 60, 28, 514
c:\Users\AORUS\Desktop\Work_Echart\EChartSimple\js\监控版\能源应用\专家排行.js, JavaScript, 0, 0, 0, 155, 0, 19, 9, 183
c:\Users\AORUS\Desktop\Work_Echart\EChartSimple\js\监控版\能源应用\优秀成果及孵化项目.js, JavaScript, 0, 0, 0, 405, 0, 39, 37, 481
c:\Users\AORUS\Desktop\Work_Echart\EChartSimple\js\监控版\能源应用\各类金融类排行.js, JavaScript, 0, 0, 0, 155, 0, 19, 9, 183
c:\Users\AORUS\Desktop\Work_Echart\EChartSimple\js\监控版\能源应用\合同数量增长趋势.js, JavaScript, 0, 0, 0, 1040, 0, 52, 24, 1116
c:\Users\AORUS\Desktop\Work_Echart\EChartSimple\js\监控版\能源应用\成功案例建设趋势.js, JavaScript, 0, 0, 0, 433, 0, 59, 26, 518
c:\Users\AORUS\Desktop\Work_Echart\EChartSimple\js\监控版\能源应用\成功案例排行.js, JavaScript, 0, 0, 0, 155, 0, 19, 9, 183
c:\Users\AORUS\Desktop\Work_Echart\EChartSimple\js\监控版\能源应用\最新事件列表.js, JavaScript, 0, 0, 0, 221, 0, 11, 9, 241
c:\Users\AORUS\Desktop\Work_Echart\EChartSimple\js\监控版\能源应用\能源俱乐部事件排行.js, JavaScript, 0, 0, 0, 155, 0, 19, 9, 183
c:\Users\AORUS\Desktop\Work_Echart\EChartSimple\js\监控版\能源应用\能源俱乐部类型分类.js, JavaScript, 0, 0, 0, 365, 0, 21, 31, 417
c:\Users\AORUS\Desktop\Work_Echart\EChartSimple\js\监控版\能源应用\金融产品接入趋势.js, JavaScript, 0, 0, 0, 433, 0, 59, 27, 519
c:\Users\AORUS\Desktop\Work_Echart\EChartSimple\js\监控版\能源应用\金融渠道类型分布.js, JavaScript, 0, 0, 0, 226, 0, 15, 36, 277
c:\Users\AORUS\Desktop\Work_Echart\EChartSimple\js\监控版\能源应用\领域入驻专家.js, JavaScript, 0, 0, 0, 440, 0, 42, 33, 515
c:\Users\AORUS\Desktop\Work_Echart\EChartSimple\js\监控版\能源服务\定制服务-区域对比.js, JavaScript, 0, 0, 0, 364, 0, 20, 30, 414
c:\Users\AORUS\Desktop\Work_Echart\EChartSimple\js\监控版\能源服务\定制服务-行业对比.js, JavaScript, 0, 0, 0, 506, 0, 34, 42, 582
c:\Users\AORUS\Desktop\Work_Echart\EChartSimple\js\监控版\能源服务\定制服务-订单状态.js, JavaScript, 0, 0, 0, 109, 0, 1, 15, 125
c:\Users\AORUS\Desktop\Work_Echart\EChartSimple\js\监控版\能源服务\定制服务.js, JavaScript, 0, 0, 0, 97, 0, 3, 13, 113
c:\Users\AORUS\Desktop\Work_Echart\EChartSimple\js\监控版\能源服务\定制服务列表.js, JavaScript, 0, 0, 0, 305, 0, 9, 8, 322
c:\Users\AORUS\Desktop\Work_Echart\EChartSimple\js\监控版\能源服务\定制服务消费月排行.js, JavaScript, 0, 0, 0, 208, 0, 6, 10, 224
c:\Users\AORUS\Desktop\Work_Echart\EChartSimple\js\监控版\能源服务\定制服务用户历史订单.js, JavaScript, 0, 0, 0, 163, 0, 9, 8, 180
c:\Users\AORUS\Desktop\Work_Echart\EChartSimple\js\监控版\能源服务\定制服务类型分布.js, JavaScript, 0, 0, 0, 268, 0, 16, 18, 302
c:\Users\AORUS\Desktop\Work_Echart\EChartSimple\js\监控版\能源服务\定制服务订单成果.js, JavaScript, 0, 0, 0, 182, 0, 9, 8, 199
c:\Users\AORUS\Desktop\Work_Echart\EChartSimple\js\监控版\能源服务\定制服务详情.js, JavaScript, 0, 0, 0, 110, 0, 4, 7, 121
c:\Users\AORUS\Desktop\Work_Echart\EChartSimple\js\监控版\能源服务\定制服务趋势.js, JavaScript, 0, 0, 0, 545, 0, 91, 23, 659
c:\Users\AORUS\Desktop\Work_Echart\EChartSimple\js\监控版\能源服务\报告订单服务-区域对比.js, JavaScript, 0, 0, 0, 360, 0, 20, 34, 414
c:\Users\AORUS\Desktop\Work_Echart\EChartSimple\js\监控版\能源服务\报告订单服务-行业对比.js, JavaScript, 0, 0, 0, 506, 0, 34, 41, 581
c:\Users\AORUS\Desktop\Work_Echart\EChartSimple\js\监控版\能源服务\报告订单服务-订单状态.js, JavaScript, 0, 0, 0, 108, 0, 1, 14, 123
c:\Users\AORUS\Desktop\Work_Echart\EChartSimple\js\监控版\能源服务\报告订单服务.js, JavaScript, 0, 0, 0, 97, 0, 3, 15, 115
c:\Users\AORUS\Desktop\Work_Echart\EChartSimple\js\监控版\能源服务\报告订单服务列表.js, JavaScript, 0, 0, 0, 305, 0, 9, 9, 323
c:\Users\AORUS\Desktop\Work_Echart\EChartSimple\js\监控版\能源服务\报告订单服务消费月排行.js, JavaScript, 0, 0, 0, 208, 0, 6, 10, 224
c:\Users\AORUS\Desktop\Work_Echart\EChartSimple\js\监控版\能源服务\报告订单服务用户历史订单.js, JavaScript, 0, 0, 0, 163, 0, 9, 9, 181
c:\Users\AORUS\Desktop\Work_Echart\EChartSimple\js\监控版\能源服务\报告订单服务类型分布.js, JavaScript, 0, 0, 0, 248, 0, 16, 20, 284
c:\Users\AORUS\Desktop\Work_Echart\EChartSimple\js\监控版\能源服务\报告订单服务订单成果.js, JavaScript, 0, 0, 0, 182, 0, 9, 9, 200
c:\Users\AORUS\Desktop\Work_Echart\EChartSimple\js\监控版\能源服务\报告订单服务详情.js, JavaScript, 0, 0, 0, 110, 0, 4, 9, 123
c:\Users\AORUS\Desktop\Work_Echart\EChartSimple\js\监控版\能源服务\报告订单服务趋势.js, JavaScript, 0, 0, 0, 545, 0, 91, 24, 660
c:\Users\AORUS\Desktop\Work_Echart\EChartSimple\js\监控版\能源服务\接入服务-区域对比.js, JavaScript, 0, 0, 0, 364, 0, 20, 31, 415
c:\Users\AORUS\Desktop\Work_Echart\EChartSimple\js\监控版\能源服务\接入服务-行业对比.js, JavaScript, 0, 0, 0, 506, 0, 34, 41, 581
c:\Users\AORUS\Desktop\Work_Echart\EChartSimple\js\监控版\能源服务\接入服务-订单状态.js, JavaScript, 0, 0, 0, 113, 0, 1, 14, 128
c:\Users\AORUS\Desktop\Work_Echart\EChartSimple\js\监控版\能源服务\接入服务类型分布.js, JavaScript, 0, 0, 0, 256, 0, 16, 19, 291
c:\Users\AORUS\Desktop\Work_Echart\EChartSimple\js\监控版\能源服务\接入服务详情.js, JavaScript, 0, 0, 0, 110, 0, 4, 8, 122
c:\Users\AORUS\Desktop\Work_Echart\EChartSimple\js\监控版\能源服务\接入详情.js, JavaScript, 0, 0, 0, 305, 0, 9, 8, 322
c:\Users\AORUS\Desktop\Work_Echart\EChartSimple\js\监控版\能源服务\数据接入服务.js, JavaScript, 0, 0, 0, 93, 0, 3, 14, 110
c:\Users\AORUS\Desktop\Work_Echart\EChartSimple\js\监控版\能源服务\数据接入服务列表.js, JavaScript, 0, 0, 0, 305, 0, 8, 10, 323
c:\Users\AORUS\Desktop\Work_Echart\EChartSimple\js\监控版\能源服务\数据接入服务趋势.js, JavaScript, 0, 0, 0, 544, 0, 91, 25, 660
c:\Users\AORUS\Desktop\Work_Echart\EChartSimple\js\监控版\能源服务\最新接入企业.js, JavaScript, 0, 0, 0, 184, 0, 6, 9, 199
c:\Users\AORUS\Desktop\Work_Echart\EChartSimple\js\监控版\能源服务\服务数量年度对比.js, JavaScript, 0, 0, 0, 598, 0, 33, 95, 726
c:\Users\AORUS\Desktop\Work_Echart\EChartSimple\js\监控版\能源服务\服务金额年度对比.js, JavaScript, 0, 0, 0, 537, 0, 25, 83, 645
c:\Users\AORUS\Desktop\Work_Echart\EChartSimple\js\监控版\能源监控\企业监控\企业概况.js, JavaScript, 0, 0, 0, 88, 0, 5, 11, 104
c:\Users\AORUS\Desktop\Work_Echart\EChartSimple\js\监控版\能源监控\企业监控\企业用能结构.js, JavaScript, 0, 0, 0, 238, 0, 19, 17, 274
c:\Users\AORUS\Desktop\Work_Echart\EChartSimple\js\监控版\能源监控\企业监控\全区概况.js, JavaScript, 0, 0, 0, 151, 0, 11, 20, 182
c:\Users\AORUS\Desktop\Work_Echart\EChartSimple\js\监控版\能源监控\企业监控\区域用户分布占比.js, JavaScript, 0, 0, 0, 255, 0, 18, 19, 292
c:\Users\AORUS\Desktop\Work_Echart\EChartSimple\js\监控版\能源监控\企业监控\当日能耗-区域属性.js, JavaScript, 0, 0, 0, 995, 0, 25, 43, 1063
c:\Users\AORUS\Desktop\Work_Echart\EChartSimple\js\监控版\能源监控\企业监控\当日能耗-设备属性.js, JavaScript, 0, 0, 0, 995, 0, 25, 45, 1065
c:\Users\AORUS\Desktop\Work_Echart\EChartSimple\js\监控版\能源监控\企业监控\本月用能趋势.js, JavaScript, 0, 0, 0, 880, 0, 19, 32, 931
c:\Users\AORUS\Desktop\Work_Echart\EChartSimple\js\监控版\能源监控\企业监控\行业用户分布占比.js, JavaScript, 0, 0, 0, 148, 0, 3, 8, 159
c:\Users\AORUS\Desktop\Work_Echart\EChartSimple\js\监控版\能源监控\全景监控\全区概况.js, JavaScript, 0, 0, 0, 150, 0, 12, 23, 185
c:\Users\AORUS\Desktop\Work_Echart\EChartSimple\js\监控版\能源监控\全景监控\区域用户分布占比.js, JavaScript, 0, 0, 0, 260, 0, 12, 28, 300
c:\Users\AORUS\Desktop\Work_Echart\EChartSimple\js\监控版\能源监控\全景监控\当月供需对比图.js, JavaScript, 0, 0, 0, 1915, 0, 39, 51, 2005
c:\Users\AORUS\Desktop\Work_Echart\EChartSimple\js\监控版\能源监控\全景监控\当月分区消费排名.js, JavaScript, 0, 0, 0, 392, 0, 15, 41, 448
c:\Users\AORUS\Desktop\Work_Echart\EChartSimple\js\监控版\能源监控\全景监控\当月能源消费重点监测.js, JavaScript, 0, 0, 0, 643, 0, 19, 35, 697
c:\Users\AORUS\Desktop\Work_Echart\EChartSimple\js\监控版\能源监控\全景监控\当月行业消费排名.js, JavaScript, 0, 0, 0, 518, 0, 47, 40, 605
c:\Users\AORUS\Desktop\Work_Echart\EChartSimple\js\监控版\能源监控\全景监控\行业用户分布占比.js, JavaScript, 0, 0, 0, 149, 0, 7, 11, 167
c:\Users\AORUS\Desktop\Work_Echart\EChartSimple\js\监控版\能源管理\ColorCard.js, JavaScript, 0, 0, 0, 28, 0, 0, 2, 30
c:\Users\AORUS\Desktop\Work_Echart\EChartSimple\js\监控版\能源管理\上海通用重工集团有限公司.js, JavaScript, 0, 0, 0, 570, 0, 61, 56, 687
c:\Users\AORUS\Desktop\Work_Echart\EChartSimple\js\监控版\能源管理\事件完成情况.js, JavaScript, 0, 0, 0, 248, 0, 7, 46, 301
c:\Users\AORUS\Desktop\Work_Echart\EChartSimple\js\监控版\能源管理\企业出力曲线 - 带标题.js, JavaScript, 0, 0, 0, 490, 0, 30, 23, 543
c:\Users\AORUS\Desktop\Work_Echart\EChartSimple\js\监控版\能源管理\企业出力曲线 - 纯图片.js, JavaScript, 0, 0, 0, 491, 0, 35, 20, 546
c:\Users\AORUS\Desktop\Work_Echart\EChartSimple\js\监控版\能源管理\企业出力曲线 - 表-纯图片.js, JavaScript, 0, 0, 0, 491, 0, 134, 33, 658
c:\Users\AORUS\Desktop\Work_Echart\EChartSimple\js\监控版\能源管理\企业出力曲线.js, JavaScript, 0, 0, 0, 489, 0, 134, 32, 655
c:\Users\AORUS\Desktop\Work_Echart\EChartSimple\js\监控版\能源管理\企业出力曲线数据绑定版_完结.js, JavaScript, 0, 0, 0, 1008, 0, 7, 18, 1033
c:\Users\AORUS\Desktop\Work_Echart\EChartSimple\js\监控版\能源管理\企业出力曲线数据绑定版_执行.js, JavaScript, 0, 0, 0, 962, 0, 7, 17, 986
c:\Users\AORUS\Desktop\Work_Echart\EChartSimple\js\监控版\能源管理\削峰填谷事件概览.js, JavaScript, 0, 0, 0, 369, 0, 25, 46, 440
c:\Users\AORUS\Desktop\Work_Echart\EChartSimple\js\监控版\能源管理\削峰填谷地图.js, JavaScript, 0, 0, 0, 364, 0, 26, 16, 406
c:\Users\AORUS\Desktop\Work_Echart\EChartSimple\js\监控版\能源管理\削峰填谷详情.js, JavaScript, 0, 0, 0, 120, 0, 5, 15, 140
c:\Users\AORUS\Desktop\Work_Echart\EChartSimple\js\监控版\能源管理\同意邀约企业.js, JavaScript, 0, 0, 0, 90, 0, 1, 11, 102
c:\Users\AORUS\Desktop\Work_Echart\EChartSimple\js\监控版\能源管理\完结-企业出力回顾.js, JavaScript, 0, 0, 0, 570, 0, 59, 60, 689
c:\Users\AORUS\Desktop\Work_Echart\EChartSimple\js\监控版\能源管理\实时全口径负荷.js, JavaScript, 0, 0, 0, 587, 0, 19, 27, 633
c:\Users\AORUS\Desktop\Work_Echart\EChartSimple\js\监控版\能源管理\底部切换.js, JavaScript, 0, 0, 0, 7, 0, 1, 0, 8
c:\Users\AORUS\Desktop\Work_Echart\EChartSimple\js\监控版\能源管理\待应答企业.js, JavaScript, 0, 0, 0, 94, 0, 1, 12, 107
c:\Users\AORUS\Desktop\Work_Echart\EChartSimple\js\监控版\能源管理\执行倒计时.js, JavaScript, 0, 0, 0, 88, 0, 3, 11, 102
c:\Users\AORUS\Desktop\Work_Echart\EChartSimple\js\监控版\能源管理\执行进度.js, JavaScript, 0, 0, 0, 435, 0, 41, 69, 545
c:\Users\AORUS\Desktop\Work_Echart\EChartSimple\js\监控版\能源管理\拒绝邀约企业.js, JavaScript, 0, 0, 0, 114, 0, 18, 6, 138
c:\Users\AORUS\Desktop\Work_Echart\EChartSimple\js\监控版\能源管理\时间轴.js, JavaScript, 0, 0, 0, 58, 0, 0, 9, 67
c:\Users\AORUS\Desktop\Work_Echart\EChartSimple\js\监控版\能源管理\最新削峰填谷事件.js, JavaScript, 0, 0, 0, 321, 0, 8, 25, 354
c:\Users\AORUS\Desktop\Work_Echart\EChartSimple\js\监控版\能源管理\线路实时态势.js, JavaScript, 0, 0, 0, 327, 0, 8, 26, 361
c:\Users\AORUS\Desktop\Work_Echart\EChartSimple\js\监控版\能源管理\虚拟电厂出力曲线.js, JavaScript, 0, 0, 0, 493, 0, 49, 35, 577
c:\Users\AORUS\Desktop\Work_Echart\EChartSimple\js\监控版\能源管理\负载曲线.js, JavaScript, 0, 0, 0, 783, 0, 20, 31, 834
c:\Users\AORUS\Desktop\Work_Echart\EChartSimple\js\监控版\能源管理\邀约倒计时.js, JavaScript, 0, 0, 0, 88, 0, 3, 11, 102
c:\Users\AORUS\Desktop\Work_Echart\EChartSimple\js\监控版\能源管理\邀约进度.js, JavaScript, 0, 0, 0, 321, 0, 15, 35, 371
c:\Users\AORUS\Desktop\Work_Echart\EChartSimple\js\监控版\能源管理\高负载线路.js, JavaScript, 0, 0, 0, 279, 0, 11, 22, 312
c:\Users\AORUS\Desktop\Work_Echart\EChartSimple\js\监控版\驾驶舱\全区用能概况.js, JavaScript, 0, 0, 0, 337, 0, 5, 34, 376
c:\Users\AORUS\Desktop\Work_Echart\EChartSimple\js\监控版\驾驶舱\削峰填谷事件概览.js, JavaScript, 0, 0, 0, 369, 0, 26, 47, 442
c:\Users\AORUS\Desktop\Work_Echart\EChartSimple\js\监控版\驾驶舱\合同数量增长趋势.js, JavaScript, 0, 0, 0, 618, 0, 14, 20, 652
c:\Users\AORUS\Desktop\Work_Echart\EChartSimple\js\监控版\驾驶舱\最新削峰填谷事件.js, JavaScript, 0, 0, 0, 276, 0, 6, 11, 293
c:\Users\AORUS\Desktop\Work_Echart\EChartSimple\js\监控版\驾驶舱\最新异常事件.js, JavaScript, 0, 0, 0, 278, 0, 6, 10, 294
c:\Users\AORUS\Desktop\Work_Echart\EChartSimple\js\监控版\驾驶舱\服务概况-个性化定制服务.js, JavaScript, 0, 0, 0, 143, 0, 1, 8, 152
c:\Users\AORUS\Desktop\Work_Echart\EChartSimple\js\监控版\驾驶舱\服务概况-分析报告订单服务.js, JavaScript, 0, 0, 0, 143, 0, 1, 7, 151
c:\Users\AORUS\Desktop\Work_Echart\EChartSimple\js\监控版\驾驶舱\服务概况-数据接入服务.js, JavaScript, 0, 0, 0, 143, 0, 1, 8, 152
c:\Users\AORUS\Desktop\Work_Echart\EChartSimple\js\监控版\驾驶舱\本月异常用能事件.js, JavaScript, 0, 0, 0, 97, 0, 4, 14, 115
c:\Users\AORUS\Desktop\Work_Echart\EChartSimple\js\监控版\驾驶舱\标签云.js, JavaScript, 0, 0, 0, 84, 0, 3, 9, 96
c:\Users\AORUS\Desktop\Work_Echart\EChartSimple\js\监控版\驾驶舱\标签云_New.js, JavaScript, 0, 0, 0, 220, 0, 3, 25, 248
c:\Users\AORUS\Desktop\Work_Echart\EChartSimple\js\监控版\驾驶舱\标签全生命周期.js, JavaScript, 0, 0, 0, 99, 0, 1, 8, 108
c:\Users\AORUS\Desktop\Work_Echart\EChartSimple\js\监控版\驾驶舱\标签概况.js, JavaScript, 0, 0, 0, 316, 0, 16, 37, 369
c:\Users\AORUS\Desktop\Work_Echart\EChartSimple\js\监控版\驾驶舱\能源交易概况.js, JavaScript, 0, 0, 0, 251, 0, 6, 37, 294
c:\Users\AORUS\Desktop\Work_Echart\EChartSimple\js\监控版\驾驶舱\能源应用.js, JavaScript, 0, 0, 0, 162, 0, 1, 14, 177
c:\Users\AORUS\Desktop\Work_Echart\EChartSimple\js\监控版\驾驶舱\行业消费排名.js, JavaScript, 0, 0, 0, 488, 0, 11, 21, 520
c:\Users\AORUS\Desktop\Work_Echart\EChartSimple\js\监控版\驾驶舱\近30天供需对比.js, JavaScript, 0, 0, 0, 1628, 0, 15, 23, 1666
c:\Users\AORUS\Desktop\Work_Echart\EChartSimple\js\监控版\驾驶舱\近一年异常原因分析.js, JavaScript, 0, 0, 0, 236, 0, 11, 16, 263
c:\Users\AORUS\Desktop\Work_Echart\EChartSimple\js\监控版\驾驶舱\近一年异常原因分析b.js, JavaScript, 0, 0, 0, 586, 0, 14, 22, 622
c:\Users\AORUS\Desktop\Work_Echart\EChartSimple\js\监控版\驾驶舱\重点监控企业-能耗.js, JavaScript, 0, 0, 0, 672, 0, 15, 19, 706
c:\Users\AORUS\Desktop\Work_Echart\EChartSimple\js\监控版\驾驶舱\高负载线路.js, JavaScript, 0, 0, 0, 248, 0, 9, 10, 267
c:\Users\AORUS\Desktop\Work_Echart\EChartSimple\js\矩形树图.js, JavaScript, 0, 0, 0, 201, 0, 22, 10, 233
c:\Users\AORUS\Desktop\Work_Echart\EChartSimple\js\阴影文本.js, JavaScript, 0, 0, 0, 7, 0, 16, 2, 25
c:\Users\AORUS\Desktop\Work_Echart\EChartSimple\json\ShowRealData.json, JSON, 0, 301, 0, 0, 0, 0, 0, 301
c:\Users\AORUS\Desktop\Work_Echart\EChartSimple\json\shanghai.json, JSON, 0, 14429, 0, 0, 0, 0, 0, 14429
c:\Users\AORUS\Desktop\Work_Echart\EChartSimple\json\zhangjiang.json, JSON, 0, 813, 0, 0, 0, 0, 0, 813
c:\Users\AORUS\Desktop\Work_Echart\EChartSimple\package-lock.json, JSON, 0, 910, 0, 0, 0, 0, 1, 911
Total, -, 490, 16645, 16056, 131790, 10233, 10070, 13467, 198751